F41,F40,F43,F42,F45,F44,F140,F47,F141,F46,F142,F49,F143,F48,F126,F127,F128,F129,F50,F52,F51,F36,F130,F35,F131,F38,F132,F37,F133,F134,F39,F135,F136,F137,F138,F139,
7,0.2857142857142857,0,7,0,14,25288,16151,519238,0.2857142857142857,239228,823,0.06976093468445618,46184,1180,1782,45,3007,63158,0.02585533850322584,-30033,7,-602,7,0.23019188620672695,14,1180,0,1782,45,0,3007,-602,0.23019188620672695,366589,127361,
7,0.2857142857142857,0,7,0,14,25288,16151,519238,0.2857142857142857,239228,823,0.06976093468445618,46184,1180,1782,45,3007,63158,0.02585533850322584,-30033,7,-602,7,0.23019188620672695,14,1180,0,1782,45,0,3007,-602,0.23019188620672695,366589,127361,
7,0.2857142857142857,0,7,0,14,25288,16151,519238,0.2857142857142857,239228,823,0.06976093468445618,46184,1180,1782,45,3007,63158,0.02585533850322584,-30033,7,-602,7,0.23019188620672695,14,1180,0,1782,45,0,3007,-602,0.23019188620672695,366589,127361,
7,0.2857142857142857,0,7,0,14,25288,16151,519238,0.2857142857142857,239228,823,0.06976093468445618,46184,1180,1782,45,3007,63158,0.02585533850322584,-30033,7,-602,7,0.23019188620672695,14,1180,0,1782,45,0,3007,-602,0.23019188620672695,366589,127361,
7,0.2857142857142857,0,7,0,14,25288,16151,519238,0.2857142857142857,239228,823,0.06976093468445618,46184,1180,1782,45,3007,63158,0.02585533850322584,-30033,7,-602,7,0.23019188620672695,14,1180,0,1782,45,0,3007,-602,0.23019188620672695,366589,127361,
7,0.2857142857142857,0,7,0,14,25288,16151,519238,0.2857142857142857,239228,823,0.06976093468445618,46184,1180,1782,45,3007,63158,0.02585533850322584,-30033,7,-602,7,0.23019188620672695,14,1180,0,1782,45,0,3007,-602,0.23019188620672695,366589,127361,
7,0.2857142857142857,0,7,0,14,25288,16151,519238,0.2857142857142857,239228,823,0.06976093468445618,46184,1180,1782,45,3007,63158,0.02585533850322584,-30033,7,-602,7,0.23019188620672695,14,1180,0,1782,45,0,3007,-602,0.23019188620672695,366589,127361,
7,0.2857142857142857,0,7,0,14,25288,16151,519238,0.2857142857142857,239228,823,0.06976093468445618,46184,1180,1782,45,3007,63158,0.02585533850322584,-30033,7,-602,7,0.23019188620672695,14,1180,0,1782,45,0,3007,-602,0.23019188620672695,366589,127361,
7,0.2857142857142857,0,7,0,14,25288,16151,519238,0.2857142857142857,239228,823,0.06976093468445618,46184,1180,1782,45,3007,63158,0.02585533850322584,-30033,7,-602,7,0.23019188620672695,14,1180,0,1782,45,0,3007,-602,0.23019188620672695,366589,127361,
7,0.2857142857142857,0,7,0,14,25288,16151,519238,0.2857142857142857,239228,823,0.06976093468445618,46184,1180,1782,45,3007,63158,0.02585533850322584,-30033,7,-602,7,0.23019188620672695,14,1180,0,1782,45,0,3007,-602,0.23019188620672695,366589,127361,
8,0.05485232067510549,1,88,-80,97,25288,16151,519238,0.02803633498550295,239228,823,0.06976093468445618,46184,213,43,8,264,63158,0.02585533850322584,-30033,10,170,2,0.02957025221319546,13,971,1,179,28,-8,1178,792,0.02911188683451146,366589,127361,
15,0.09090909090909091,0,47,-32,62,25288,16151,519238,0.033751051685834296,239228,823,0.06976093468445618,46184,102,35,2,139,63158,0.02585533850322584,-30033,10,67,4,0.03321415154584327,14,331,0,96,58,-6,485,235,0.01708683138653023,366589,127361,
8,0.0,1,88,-80,97,25288,16151,519238,0.02803633498550295,239228,823,0.06976093468445618,46184,121,1,0,122,63158,0.02585533850322584,-30033,0,120,0,0.27619808193720463,0,971,0,179,28,0,1178,792,0.02911188683451146,366589,127361,
33,0.0975609756097561,2,9,24,44,25288,16151,519238,0.030422622645774746,239228,823,0.06976093468445618,46184,65,199,388,652,63158,0.02585533850322584,-30033,5,-134,18,0.2121697540782075,24,910,1,259,1301,13,2470,651,0.11532355691996297,366589,127361,
0,0.0,0,0,0,0,25288,16151,519238,0.0,239228,823,0.06976093468445618,46184,7,0,1,8,63158,0.02585533850322584,-30033,0,7,0,0.009569377990430622,0,1140,0,8,1,0,1149,1132,0.009613015301175344,366589,127361,
0,0.0,0,0,0,0,25288,16151,519238,0.0,239228,823,0.06976093468445618,46184,7,0,1,8,63158,0.02585533850322584,-30033,0,7,0,0.009569377990430622,0,1140,0,8,1,0,1149,1132,0.009613015301175344,366589,127361,
33,0.17307692307692307,2,9,24,44,25288,16151,519238,0.030422622645774746,239228,823,0.06976093468445618,46184,51,6,497,554,63158,0.02585533850322584,-30033,2,45,7,0.1281915396771497,9,910,0,259,1301,5,2470,651,0.11532355691996297,366589,127361,
33,0.17307692307692307,2,9,24,44,25288,16151,519238,0.030422622645774746,239228,823,0.06976093468445618,46184,51,6,497,554,63158,0.02585533850322584,-30033,2,45,7,0.1281915396771497,9,910,0,259,1301,5,2470,651,0.11532355691996297,366589,127361,
33,0.17307692307692307,2,9,24,44,25288,16151,519238,0.030422622645774746,239228,823,0.06976093468445618,46184,51,6,497,554,63158,0.02585533850322584,-30033,2,45,7,0.1281915396771497,9,910,0,259,1301,5,2470,651,0.11532355691996297,366589,127361,
33,0.16666666666666666,2,9,24,44,25288,16151,519238,0.030422622645774746,239228,823,0.06976093468445618,46184,70,30,4,104,63158,0.02585533850322584,-30033,1,40,4,0.204223495180942,6,910,1,259,1301,3,2470,651,0.11532355691996297,366589,127361,
33,0.16666666666666666,2,9,24,44,25288,16151,519238,0.030422622645774746,239228,823,0.06976093468445618,46184,70,30,4,104,63158,0.02585533850322584,-30033,1,40,4,0.204223495180942,6,910,1,259,1301,3,2470,651,0.11532355691996297,366589,127361,
33,0.16666666666666666,2,9,24,44,25288,16151,519238,0.030422622645774746,239228,823,0.06976093468445618,46184,70,30,4,104,63158,0.02585533850322584,-30033,1,40,4,0.204223495180942,6,910,1,259,1301,3,2470,651,0.11532355691996297,366589,127361,
33,0.16666666666666666,2,9,24,44,25288,16151,519238,0.030422622645774746,239228,823,0.06976093468445618,46184,70,30,4,104,63158,0.02585533850322584,-30033,1,40,4,0.204223495180942,6,910,1,259,1301,3,2470,651,0.11532355691996297,366589,127361,
33,0.16666666666666666,2,9,24,44,25288,16151,519238,0.030422622645774746,239228,823,0.06976093468445618,46184,70,30,4,104,63158,0.02585533850322584,-30033,1,40,4,0.204223495180942,6,910,1,259,1301,3,2470,651,0.11532355691996297,366589,127361,
33,0.0,2,9,24,44,25288,16151,519238,0.030422622645774746,239228,823,0.06976093468445618,46184,34,12,9,55,63158,0.02585533850322584,-30033,0,22,0,0.17405063291139242,0,910,0,259,1301,0,2470,651,0.11532355691996297,366589,127361,
33,0.0,2,9,24,44,25288,16151,519238,0.030422622645774746,239228,823,0.06976093468445618,46184,34,12,9,55,63158,0.02585533850322584,-30033,0,22,0,0.17405063291139242,0,910,0,259,1301,0,2470,651,0.11532355691996297,366589,127361,
15,0.12418300653594772,0,4,11,19,25288,16151,519238,0.06209150326797386,239228,823,0.06976093468445618,46184,244,4,0,248,63158,0.02585533850322584,-30033,4,240,15,0.19663909433730406,19,273,0,4,0,11,277,269,0.11444857942671655,366589,127361,
1,0.0,0,1,0,2,25288,16151,519238,6.49772579597141E-4,239228,823,0.06976093468445618,46184,0,0,149,149,63158,0.02585533850322584,-30033,0,0,0,0.0966277561608301,0,1464,0,45,4194,0,5703,1419,0.016553156262268533,366589,127361,
1,0.0,0,1,0,2,25288,16151,519238,6.49772579597141E-4,239228,823,0.06976093468445618,46184,0,0,149,149,63158,0.02585533850322584,-30033,0,0,0,0.0966277561608301,0,1464,0,45,4194,0,5703,1419,0.016553156262268533,366589,127361,
1,0.0,0,1,0,2,25288,16151,519238,6.49772579597141E-4,239228,823,0.06976093468445618,46184,0,0,82,82,63158,0.02585533850322584,-30033,0,0,0,0.03990267639902676,0,1464,0,45,4194,0,5703,1419,0.016553156262268533,366589,127361,
1,0.0,0,1,0,2,25288,16151,519238,6.49772579597141E-4,239228,823,0.06976093468445618,46184,0,0,57,57,63158,0.02585533850322584,-30033,0,0,0,0.025629496402877698,0,1464,0,45,4194,0,5703,1419,0.016553156262268533,366589,127361,
1,0.0,0,1,0,2,25288,16151,519238,6.49772579597141E-4,239228,823,0.06976093468445618,46184,0,0,57,57,63158,0.02585533850322584,-30033,0,0,0,0.025629496402877698,0,1464,0,45,4194,0,5703,1419,0.016553156262268533,366589,127361,
1,0.0,0,1,0,2,25288,16151,519238,6.49772579597141E-4,239228,823,0.06976093468445618,46184,0,0,54,54,63158,0.02585533850322584,-30033,0,0,0,0.01906106600776562,0,1464,0,45,4194,0,5703,1419,0.016553156262268533,366589,127361,
1,0.0,0,1,0,2,25288,16151,519238,6.49772579597141E-4,239228,823,0.06976093468445618,46184,0,0,71,71,63158,0.02585533850322584,-30033,0,0,0,0.020681619574715992,0,1464,0,45,4194,0,5703,1419,0.016553156262268533,366589,127361,
1,0.0,0,1,0,2,25288,16151,519238,6.49772579597141E-4,239228,823,0.06976093468445618,46184,0,0,71,71,63158,0.02585533850322584,-30033,0,0,0,0.020681619574715992,0,1464,0,45,4194,0,5703,1419,0.016553156262268533,366589,127361,
1,0.0,0,1,0,2,25288,16151,519238,6.49772579597141E-4,239228,823,0.06976093468445618,46184,360,2,0,362,63158,0.02585533850322584,-30033,0,358,0,0.07603064431639601,0,1464,0,45,4194,0,5703,1419,0.016553156262268533,366589,127361,
1,0.0,0,1,0,2,25288,16151,519238,6.49772579597141E-4,239228,823,0.06976093468445618,46184,360,2,0,362,63158,0.02585533850322584,-30033,0,358,0,0.07603064431639601,0,1464,0,45,4194,0,5703,1419,0.016553156262268533,366589,127361,
1,0.0,0,1,0,2,25288,16151,519238,6.49772579597141E-4,239228,823,0.06976093468445618,46184,173,0,0,173,63158,0.02585533850322584,-30033,0,173,0,0.01027559990496555,0,1464,0,45,4194,0,5703,1419,0.016553156262268533,366589,127361,
1,0.0,0,1,0,2,25288,16151,519238,6.49772579597141E-4,239228,823,0.06976093468445618,46184,173,0,0,173,63158,0.02585533850322584,-30033,0,173,0,0.01027559990496555,0,1464,0,45,4194,0,5703,1419,0.016553156262268533,366589,127361,
1,0.0,0,1,0,2,25288,16151,519238,6.49772579597141E-4,239228,823,0.06976093468445618,46184,173,0,0,173,63158,0.02585533850322584,-30033,0,173,0,0.01027559990496555,0,1464,0,45,4194,0,5703,1419,0.016553156262268533,366589,127361,
1,0.0,0,1,0,2,25288,16151,519238,6.49772579597141E-4,239228,823,0.06976093468445618,46184,0,0,50,50,63158,0.02585533850322584,-30033,0,0,0,0.00972951936174353,0,1464,0,45,4194,0,5703,1419,0.016553156262268533,366589,127361,
1,0.0,0,1,0,2,25288,16151,519238,6.49772579597141E-4,239228,823,0.06976093468445618,46184,0,0,88,88,63158,0.02585533850322584,-30033,0,0,0,0.01456953642384106,0,1464,0,45,4194,0,5703,1419,0.016553156262268533,366589,127361,
1,0.0,0,1,0,2,25288,16151,519238,6.49772579597141E-4,239228,823,0.06976093468445618,46184,0,0,88,88,63158,0.02585533850322584,-30033,0,0,0,0.01456953642384106,0,1464,0,45,4194,0,5703,1419,0.016553156262268533,366589,127361,
1,0.0,0,1,0,2,25288,16151,519238,6.49772579597141E-4,239228,823,0.06976093468445618,46184,0,0,103,103,63158,0.02585533850322584,-30033,0,0,0,0.016377802512323104,0,1464,0,45,4194,0,5703,1419,0.016553156262268533,366589,127361,
1,0.0,0,1,0,2,25288,16151,519238,6.49772579597141E-4,239228,823,0.06976093468445618,46184,0,0,103,103,63158,0.02585533850322584,-30033,0,0,0,0.016377802512323104,0,1464,0,45,4194,0,5703,1419,0.016553156262268533,366589,127361,
1,0.0,0,1,0,2,25288,16151,519238,6.49772579597141E-4,239228,823,0.06976093468445618,46184,60,0,0,60,63158,0.02585533850322584,-30033,0,60,0,0.003390788358293303,0,1464,0,45,4194,0,5703,1419,0.016553156262268533,366589,127361,
1,0.0,0,1,0,2,25288,16151,519238,6.49772579597141E-4,239228,823,0.06976093468445618,46184,60,0,0,60,63158,0.02585533850322584,-30033,0,60,0,0.003390788358293303,0,1464,0,45,4194,0,5703,1419,0.016553156262268533,366589,127361,
1,0.0,0,1,0,2,25288,16151,519238,6.49772579597141E-4,239228,823,0.06976093468445618,46184,0,0,128,128,63158,0.02585533850322584,-30033,0,0,0,0.019411586290567183,0,1464,0,45,4194,0,5703,1419,0.016553156262268533,366589,127361,
1,0.0,0,1,0,2,25288,16151,519238,6.49772579597141E-4,239228,823,0.06976093468445618,46184,0,0,128,128,63158,0.02585533850322584,-30033,0,0,0,0.019411586290567183,0,1464,0,45,4194,0,5703,1419,0.016553156262268533,366589,127361,
1,0.0,0,1,0,2,25288,16151,519238,6.49772579597141E-4,239228,823,0.06976093468445618,46184,0,0,73,73,63158,0.02585533850322584,-30033,0,0,0,0.010749521425415992,0,1464,0,45,4194,0,5703,1419,0.016553156262268533,366589,127361,
1,0.0,0,1,0,2,25288,16151,519238,6.49772579597141E-4,239228,823,0.06976093468445618,46184,0,0,73,73,63158,0.02585533850322584,-30033,0,0,0,0.010749521425415992,0,1464,0,45,4194,0,5703,1419,0.016553156262268533,366589,127361,
1,0.0,0,1,0,2,25288,16151,519238,6.49772579597141E-4,239228,823,0.06976093468445618,46184,214,0,228,442,63158,0.02585533850322584,-30033,0,214,0,0.02093644428917684,0,1464,0,45,4194,0,5703,1419,0.016553156262268533,366589,127361,
1,0.0,0,1,0,2,25288,16151,519238,6.49772579597141E-4,239228,823,0.06976093468445618,46184,214,0,228,442,63158,0.02585533850322584,-30033,0,214,0,0.02093644428917684,0,1464,0,45,4194,0,5703,1419,0.016553156262268533,366589,127361,
1,0.0,0,1,0,2,25288,16151,519238,6.49772579597141E-4,239228,823,0.06976093468445618,46184,0,0,116,116,63158,0.02585533850322584,-30033,0,0,0,0.010696173351775012,0,1464,0,45,4194,0,5703,1419,0.016553156262268533,366589,127361,
1,0.05263157894736842,0,1,0,2,25288,16151,519238,6.49772579597141E-4,239228,823,0.06976093468445618,46184,77,4,0,81,63158,0.02585533850322584,-30033,1,73,1,0.030465376435827612,2,1464,0,45,4194,0,5703,1419,0.016553156262268533,366589,127361,
1,0.0,0,1,0,2,25288,16151,519238,6.49772579597141E-4,239228,823,0.06976093468445618,46184,0,0,71,71,63158,0.02585533850322584,-30033,0,0,0,0.005663236819015713,0,1464,0,45,4194,0,5703,1419,0.016553156262268533,366589,127361,
1,0.0,0,1,0,2,25288,16151,519238,6.49772579597141E-4,239228,823,0.06976093468445618,46184,0,0,71,71,63158,0.02585533850322584,-30033,0,0,0,0.005663236819015713,0,1464,0,45,4194,0,5703,1419,0.016553156262268533,366589,127361,
1,0.0,0,1,0,2,25288,16151,519238,6.49772579597141E-4,239228,823,0.06976093468445618,46184,0,0,136,136,63158,0.02585533850322584,-30033,0,0,0,0.009564666994866024,0,1464,0,45,4194,0,5703,1419,0.016553156262268533,366589,127361,
1,0.0,0,1,0,2,25288,16151,519238,6.49772579597141E-4,239228,823,0.06976093468445618,46184,0,0,136,136,63158,0.02585533850322584,-30033,0,0,0,0.009564666994866024,0,1464,0,45,4194,0,5703,1419,0.016553156262268533,366589,127361,
13,0.20634920634920634,0,19,-6,32,25288,16151,519238,0.03537446551618063,239228,823,0.06976093468445618,46184,465,16,449,930,63158,0.02585533850322584,-30033,13,449,0,0.0802794866601578,13,953,0,25,831,-13,1809,928,0.032382791631742916,366589,127361,
13,0.20634920634920634,0,19,-6,32,25288,16151,519238,0.03537446551618063,239228,823,0.06976093468445618,46184,465,16,449,930,63158,0.02585533850322584,-30033,13,449,0,0.0802794866601578,13,953,0,25,831,-13,1809,928,0.032382791631742916,366589,127361,
13,0.20634920634920634,0,19,-6,32,25288,16151,519238,0.03537446551618063,239228,823,0.06976093468445618,46184,465,16,449,930,63158,0.02585533850322584,-30033,13,449,0,0.0802794866601578,13,953,0,25,831,-13,1809,928,0.032382791631742916,366589,127361,
13,0.20634920634920634,0,19,-6,32,25288,16151,519238,0.03537446551618063,239228,823,0.06976093468445618,46184,465,16,449,930,63158,0.02585533850322584,-30033,13,449,0,0.0802794866601578,13,953,0,25,831,-13,1809,928,0.032382791631742916,366589,127361,
13,0.20634920634920634,0,19,-6,32,25288,16151,519238,0.03537446551618063,239228,823,0.06976093468445618,46184,465,16,449,930,63158,0.02585533850322584,-30033,13,449,0,0.0802794866601578,13,953,0,25,831,-13,1809,928,0.032382791631742916,366589,127361,
13,0.20634920634920634,0,19,-6,32,25288,16151,519238,0.03537446551618063,239228,823,0.06976093468445618,46184,465,16,449,930,63158,0.02585533850322584,-30033,13,449,0,0.0802794866601578,13,953,0,25,831,-13,1809,928,0.032382791631742916,366589,127361,
13,0.20634920634920634,0,19,-6,32,25288,16151,519238,0.03537446551618063,239228,823,0.06976093468445618,46184,465,16,449,930,63158,0.02585533850322584,-30033,13,449,0,0.0802794866601578,13,953,0,25,831,-13,1809,928,0.032382791631742916,366589,127361,
13,0.0,0,19,-6,32,25288,16151,519238,0.03537446551618063,239228,823,0.06976093468445618,46184,269,3,0,272,63158,0.02585533850322584,-30033,0,266,0,0.1223188985565223,0,953,0,25,831,0,1809,928,0.032382791631742916,366589,127361,
13,0.0,0,19,-6,32,25288,16151,519238,0.03537446551618063,239228,823,0.06976093468445618,46184,269,3,0,272,63158,0.02585533850322584,-30033,0,266,0,0.1223188985565223,0,953,0,25,831,0,1809,928,0.032382791631742916,366589,127361,
13,0.0,0,19,-6,32,25288,16151,519238,0.03537446551618063,239228,823,0.06976093468445618,46184,269,3,0,272,63158,0.02585533850322584,-30033,0,266,0,0.1223188985565223,0,953,0,25,831,0,1809,928,0.032382791631742916,366589,127361,
13,0.0,0,19,-6,32,25288,16151,519238,0.03537446551618063,239228,823,0.06976093468445618,46184,269,3,0,272,63158,0.02585533850322584,-30033,0,266,0,0.1223188985565223,0,953,0,25,831,0,1809,928,0.032382791631742916,366589,127361,
13,0.0,0,19,-6,32,25288,16151,519238,0.03537446551618063,239228,823,0.06976093468445618,46184,0,0,249,249,63158,0.02585533850322584,-30033,0,0,0,0.014351585014409222,0,953,0,25,831,0,1809,928,0.032382791631742916,366589,127361,
13,0.0,0,19,-6,32,25288,16151,519238,0.03537446551618063,239228,823,0.06976093468445618,46184,0,0,249,249,63158,0.02585533850322584,-30033,0,0,0,0.014351585014409222,0,953,0,25,831,0,1809,928,0.032382791631742916,366589,127361,
13,0.0,0,19,-6,32,25288,16151,519238,0.03537446551618063,239228,823,0.06976093468445618,46184,0,0,249,249,63158,0.02585533850322584,-30033,0,0,0,0.014351585014409222,0,953,0,25,831,0,1809,928,0.032382791631742916,366589,127361,
13,0.0,0,19,-6,32,25288,16151,519238,0.03537446551618063,239228,823,0.06976093468445618,46184,0,0,249,249,63158,0.02585533850322584,-30033,0,0,0,0.014351585014409222,0,953,0,25,831,0,1809,928,0.032382791631742916,366589,127361,
2,0.1724137931034483,1,2,0,5,25288,16151,519238,0.1724137931034483,239228,823,0.06976093468445618,46184,135,3,1,139,63158,0.02585533850322584,-30033,2,132,2,0.2965604484285372,5,135,1,3,1,0,139,132,0.2965604484285372,366589,127361,
2,0.1724137931034483,1,2,0,5,25288,16151,519238,0.1724137931034483,239228,823,0.06976093468445618,46184,135,3,1,139,63158,0.02585533850322584,-30033,2,132,2,0.2965604484285372,5,135,1,3,1,0,139,132,0.2965604484285372,366589,127361,
334,0.17477477477477477,26,63,271,423,25288,16151,519238,0.06577132548487204,239228,823,0.06976093468445618,46184,277,124,33,434,63158,0.02585533850322584,-30033,1,153,9,0.27462498486433223,10,4722,0,282,2554,8,7558,4440,0.09376159484563264,366589,127361,
334,0.17477477477477477,26,63,271,423,25288,16151,519238,0.06577132548487204,239228,823,0.06976093468445618,46184,277,124,33,434,63158,0.02585533850322584,-30033,1,153,9,0.27462498486433223,10,4722,0,282,2554,8,7558,4440,0.09376159484563264,366589,127361,
334,0.17477477477477477,26,63,271,423,25288,16151,519238,0.06577132548487204,239228,823,0.06976093468445618,46184,277,124,33,434,63158,0.02585533850322584,-30033,1,153,9,0.27462498486433223,10,4722,0,282,2554,8,7558,4440,0.09376159484563264,366589,127361,
334,0.17477477477477477,26,63,271,423,25288,16151,519238,0.06577132548487204,239228,823,0.06976093468445618,46184,277,124,33,434,63158,0.02585533850322584,-30033,1,153,9,0.27462498486433223,10,4722,0,282,2554,8,7558,4440,0.09376159484563264,366589,127361,
334,0.17477477477477477,26,63,271,423,25288,16151,519238,0.06577132548487204,239228,823,0.06976093468445618,46184,277,124,33,434,63158,0.02585533850322584,-30033,1,153,9,0.27462498486433223,10,4722,0,282,2554,8,7558,4440,0.09376159484563264,366589,127361,
334,0.17477477477477477,26,63,271,423,25288,16151,519238,0.06577132548487204,239228,823,0.06976093468445618,46184,277,124,33,434,63158,0.02585533850322584,-30033,1,153,9,0.27462498486433223,10,4722,0,282,2554,8,7558,4440,0.09376159484563264,366589,127361,
334,0.17477477477477477,26,63,271,423,25288,16151,519238,0.06577132548487204,239228,823,0.06976093468445618,46184,277,124,33,434,63158,0.02585533850322584,-30033,1,153,9,0.27462498486433223,10,4722,0,282,2554,8,7558,4440,0.09376159484563264,366589,127361,
334,0.14705882352941177,26,63,271,423,25288,16151,519238,0.06577132548487204,239228,823,0.06976093468445618,46184,228,16,474,718,63158,0.02585533850322584,-30033,0,212,10,0.2649285657978633,10,4722,0,282,2554,10,7558,4440,0.09376159484563264,366589,127361,
334,0.14705882352941177,26,63,271,423,25288,16151,519238,0.06577132548487204,239228,823,0.06976093468445618,46184,228,16,474,718,63158,0.02585533850322584,-30033,0,212,10,0.2649285657978633,10,4722,0,282,2554,10,7558,4440,0.09376159484563264,366589,127361,
334,0.14705882352941177,26,63,271,423,25288,16151,519238,0.06577132548487204,239228,823,0.06976093468445618,46184,228,16,474,718,63158,0.02585533850322584,-30033,0,212,10,0.2649285657978633,10,4722,0,282,2554,10,7558,4440,0.09376159484563264,366589,127361,
334,0.055350553505535055,26,63,271,423,25288,16151,519238,0.06577132548487204,239228,823,0.06976093468445618,46184,391,3,0,394,63158,0.02585533850322584,-30033,3,388,12,0.08544966699666998,15,4722,0,282,2554,9,7558,4440,0.09376159484563264,366589,127361,
334,0.055350553505535055,26,63,271,423,25288,16151,519238,0.06577132548487204,239228,823,0.06976093468445618,46184,391,3,0,394,63158,0.02585533850322584,-30033,3,388,12,0.08544966699666998,15,4722,0,282,2554,9,7558,4440,0.09376159484563264,366589,127361,
334,0.055350553505535055,26,63,271,423,25288,16151,519238,0.06577132548487204,239228,823,0.06976093468445618,46184,391,3,0,394,63158,0.02585533850322584,-30033,3,388,12,0.08544966699666998,15,4722,0,282,2554,9,7558,4440,0.09376159484563264,366589,127361,
334,0.055350553505535055,26,63,271,423,25288,16151,519238,0.06577132548487204,239228,823,0.06976093468445618,46184,391,3,0,394,63158,0.02585533850322584,-30033,3,388,12,0.08544966699666998,15,4722,0,282,2554,9,7558,4440,0.09376159484563264,366589,127361,
334,0.055350553505535055,26,63,271,423,25288,16151,519238,0.06577132548487204,239228,823,0.06976093468445618,46184,391,3,0,394,63158,0.02585533850322584,-30033,3,388,12,0.08544966699666998,15,4722,0,282,2554,9,7558,4440,0.09376159484563264,366589,127361,
334,0.055350553505535055,26,63,271,423,25288,16151,519238,0.06577132548487204,239228,823,0.06976093468445618,46184,391,3,0,394,63158,0.02585533850322584,-30033,3,388,12,0.08544966699666998,15,4722,0,282,2554,9,7558,4440,0.09376159484563264,366589,127361,
334,0.055350553505535055,26,63,271,423,25288,16151,519238,0.06577132548487204,239228,823,0.06976093468445618,46184,391,3,0,394,63158,0.02585533850322584,-30033,3,388,12,0.08544966699666998,15,4722,0,282,2554,9,7558,4440,0.09376159484563264,366589,127361,
334,0.055350553505535055,26,63,271,423,25288,16151,519238,0.06577132548487204,239228,823,0.06976093468445618,46184,391,3,0,394,63158,0.02585533850322584,-30033,3,388,12,0.08544966699666998,15,4722,0,282,2554,9,7558,4440,0.09376159484563264,366589,127361,
334,0.2777777777777778,26,63,271,423,25288,16151,519238,0.06577132548487204,239228,823,0.06976093468445618,46184,390,21,8,419,63158,0.02585533850322584,-30033,1,369,4,0.1360104528800933,5,4722,0,282,2554,3,7558,4440,0.09376159484563264,366589,127361,
334,0.6125461254612546,26,63,271,423,25288,16151,519238,0.06577132548487204,239228,823,0.06976093468445618,46184,282,22,15,319,63158,0.02585533850322584,-30033,22,260,129,0.2908939445628553,166,4722,15,282,2554,107,7558,4440,0.09376159484563264,366589,127361,
334,0.6125461254612546,26,63,271,423,25288,16151,519238,0.06577132548487204,239228,823,0.06976093468445618,46184,282,22,15,319,63158,0.02585533850322584,-30033,22,260,129,0.2908939445628553,166,4722,15,282,2554,107,7558,4440,0.09376159484563264,366589,127361,
334,0.18641618497109827,26,63,271,423,25288,16151,519238,0.06577132548487204,239228,823,0.06976093468445618,46184,1110,13,1108,2231,63158,0.02585533850322584,-30033,10,1097,111,0.16350235047820194,129,4722,8,282,2554,101,7558,4440,0.09376159484563264,366589,127361,
334,0.18641618497109827,26,63,271,423,25288,16151,519238,0.06577132548487204,239228,823,0.06976093468445618,46184,1110,13,1108,2231,63158,0.02585533850322584,-30033,10,1097,111,0.16350235047820194,129,4722,8,282,2554,101,7558,4440,0.09376159484563264,366589,127361,
334,0.18641618497109827,26,63,271,423,25288,16151,519238,0.06577132548487204,239228,823,0.06976093468445618,46184,1110,13,1108,2231,63158,0.02585533850322584,-30033,10,1097,111,0.16350235047820194,129,4722,8,282,2554,101,7558,4440,0.09376159484563264,366589,127361,
334,0.18641618497109827,26,63,271,423,25288,16151,519238,0.06577132548487204,239228,823,0.06976093468445618,46184,1110,13,1108,2231,63158,0.02585533850322584,-30033,10,1097,111,0.16350235047820194,129,4722,8,282,2554,101,7558,4440,0.09376159484563264,366589,127361,
334,0.18641618497109827,26,63,271,423,25288,16151,519238,0.06577132548487204,239228,823,0.06976093468445618,46184,1110,13,1108,2231,63158,0.02585533850322584,-30033,10,1097,111,0.16350235047820194,129,4722,8,282,2554,101,7558,4440,0.09376159484563264,366589,127361,
334,0.18641618497109827,26,63,271,423,25288,16151,519238,0.06577132548487204,239228,823,0.06976093468445618,46184,1110,13,1108,2231,63158,0.02585533850322584,-30033,10,1097,111,0.16350235047820194,129,4722,8,282,2554,101,7558,4440,0.09376159484563264,366589,127361,
334,0.18641618497109827,26,63,271,423,25288,16151,519238,0.06577132548487204,239228,823,0.06976093468445618,46184,1110,13,1108,2231,63158,0.02585533850322584,-30033,10,1097,111,0.16350235047820194,129,4722,8,282,2554,101,7558,4440,0.09376159484563264,366589,127361,
334,0.18641618497109827,26,63,271,423,25288,16151,519238,0.06577132548487204,239228,823,0.06976093468445618,46184,1110,13,1108,2231,63158,0.02585533850322584,-30033,10,1097,111,0.16350235047820194,129,4722,8,282,2554,101,7558,4440,0.09376159484563264,366589,127361,
334,0.18641618497109827,26,63,271,423,25288,16151,519238,0.06577132548487204,239228,823,0.06976093468445618,46184,1110,13,1108,2231,63158,0.02585533850322584,-30033,10,1097,111,0.16350235047820194,129,4722,8,282,2554,101,7558,4440,0.09376159484563264,366589,127361,
334,0.18641618497109827,26,63,271,423,25288,16151,519238,0.06577132548487204,239228,823,0.06976093468445618,46184,1110,13,1108,2231,63158,0.02585533850322584,-30033,10,1097,111,0.16350235047820194,129,4722,8,282,2554,101,7558,4440,0.09376159484563264,366589,127361,
334,0.18641618497109827,26,63,271,423,25288,16151,519238,0.06577132548487204,239228,823,0.06976093468445618,46184,1110,13,1108,2231,63158,0.02585533850322584,-30033,10,1097,111,0.16350235047820194,129,4722,8,282,2554,101,7558,4440,0.09376159484563264,366589,127361,
334,0.18641618497109827,26,63,271,423,25288,16151,519238,0.06577132548487204,239228,823,0.06976093468445618,46184,1110,13,1108,2231,63158,0.02585533850322584,-30033,10,1097,111,0.16350235047820194,129,4722,8,282,2554,101,7558,4440,0.09376159484563264,366589,127361,
334,0.18641618497109827,26,63,271,423,25288,16151,519238,0.06577132548487204,239228,823,0.06976093468445618,46184,1110,13,1108,2231,63158,0.02585533850322584,-30033,10,1097,111,0.16350235047820194,129,4722,8,282,2554,101,7558,4440,0.09376159484563264,366589,127361,
334,0.18641618497109827,26,63,271,423,25288,16151,519238,0.06577132548487204,239228,823,0.06976093468445618,46184,1110,13,1108,2231,63158,0.02585533850322584,-30033,10,1097,111,0.16350235047820194,129,4722,8,282,2554,101,7558,4440,0.09376159484563264,366589,127361,
334,0.0,26,63,271,423,25288,16151,519238,0.06577132548487204,239228,823,0.06976093468445618,46184,344,11,399,754,63158,0.02585533850322584,-30033,0,333,0,0.09824803347908535,0,4722,0,282,2554,0,7558,4440,0.09376159484563264,366589,127361,
334,0.02883506343713956,26,63,271,423,25288,16151,519238,0.06577132548487204,239228,823,0.06976093468445618,46184,424,11,2,437,63158,0.02585533850322584,-30033,11,413,12,0.04203887792398678,25,4722,2,282,2554,1,7558,4440,0.09376159484563264,366589,127361,
334,0.02883506343713956,26,63,271,423,25288,16151,519238,0.06577132548487204,239228,823,0.06976093468445618,46184,424,11,2,437,63158,0.02585533850322584,-30033,11,413,12,0.04203887792398678,25,4722,2,282,2554,1,7558,4440,0.09376159484563264,366589,127361,
334,0.02883506343713956,26,63,271,423,25288,16151,519238,0.06577132548487204,239228,823,0.06976093468445618,46184,424,11,2,437,63158,0.02585533850322584,-30033,11,413,12,0.04203887792398678,25,4722,2,282,2554,1,7558,4440,0.09376159484563264,366589,127361,
334,0.02883506343713956,26,63,271,423,25288,16151,519238,0.06577132548487204,239228,823,0.06976093468445618,46184,424,11,2,437,63158,0.02585533850322584,-30033,11,413,12,0.04203887792398678,25,4722,2,282,2554,1,7558,4440,0.09376159484563264,366589,127361,
334,0.02883506343713956,26,63,271,423,25288,16151,519238,0.06577132548487204,239228,823,0.06976093468445618,46184,424,11,2,437,63158,0.02585533850322584,-30033,11,413,12,0.04203887792398678,25,4722,2,282,2554,1,7558,4440,0.09376159484563264,366589,127361,
334,0.02883506343713956,26,63,271,423,25288,16151,519238,0.06577132548487204,239228,823,0.06976093468445618,46184,424,11,2,437,63158,0.02585533850322584,-30033,11,413,12,0.04203887792398678,25,4722,2,282,2554,1,7558,4440,0.09376159484563264,366589,127361,
334,0.0,26,63,271,423,25288,16151,519238,0.06577132548487204,239228,823,0.06976093468445618,46184,0,0,62,62,63158,0.02585533850322584,-30033,0,0,0,0.006428867689755288,0,4722,0,282,2554,0,7558,4440,0.09376159484563264,366589,127361,
334,0.0,26,63,271,423,25288,16151,519238,0.06577132548487204,239228,823,0.06976093468445618,46184,81,0,83,164,63158,0.02585533850322584,-30033,0,81,0,0.008090951166076324,0,4722,0,282,2554,0,7558,4440,0.09376159484563264,366589,127361,
334,0.0,26,63,271,423,25288,16151,519238,0.06577132548487204,239228,823,0.06976093468445618,46184,0,0,62,62,63158,0.02585533850322584,-30033,0,0,0,0.006428867689755288,0,4722,0,282,2554,0,7558,4440,0.09376159484563264,366589,127361,
930,0.24625748502994013,0,0,930,930,25288,16151,519238,0.1442445828498919,239228,823,0.06976093468445618,46184,329,0,0,329,63158,0.02585533850322584,-30033,0,329,329,0.24625748502994013,329,930,0,0,0,329,930,930,0.1442445828498919,366589,127361,
930,0.24625748502994013,0,0,930,930,25288,16151,519238,0.1442445828498919,239228,823,0.06976093468445618,46184,329,0,0,329,63158,0.02585533850322584,-30033,0,329,329,0.24625748502994013,329,930,0,0,0,329,930,930,0.1442445828498919,366589,127361,
930,0.24625748502994013,0,0,930,930,25288,16151,519238,0.1442445828498919,239228,823,0.06976093468445618,46184,329,0,0,329,63158,0.02585533850322584,-30033,0,329,329,0.24625748502994013,329,930,0,0,0,329,930,930,0.1442445828498919,366589,127361,
930,0.24625748502994013,0,0,930,930,25288,16151,519238,0.1442445828498919,239228,823,0.06976093468445618,46184,329,0,0,329,63158,0.02585533850322584,-30033,0,329,329,0.24625748502994013,329,930,0,0,0,329,930,930,0.1442445828498919,366589,127361,
930,0.24625748502994013,0,0,930,930,25288,16151,519238,0.1442445828498919,239228,823,0.06976093468445618,46184,329,0,0,329,63158,0.02585533850322584,-30033,0,329,329,0.24625748502994013,329,930,0,0,0,329,930,930,0.1442445828498919,366589,127361,
930,0.24625748502994013,0,0,930,930,25288,16151,519238,0.1442445828498919,239228,823,0.06976093468445618,46184,329,0,0,329,63158,0.02585533850322584,-30033,0,329,329,0.24625748502994013,329,930,0,0,0,329,930,930,0.1442445828498919,366589,127361,
930,0.24625748502994013,0,0,930,930,25288,16151,519238,0.1442445828498919,239228,823,0.06976093468445618,46184,329,0,0,329,63158,0.02585533850322584,-30033,0,329,329,0.24625748502994013,329,930,0,0,0,329,930,930,0.1442445828498919,366589,127361,
930,0.24625748502994013,0,0,930,930,25288,16151,519238,0.1442445828498919,239228,823,0.06976093468445618,46184,329,0,0,329,63158,0.02585533850322584,-30033,0,329,329,0.24625748502994013,329,930,0,0,0,329,930,930,0.1442445828498919,366589,127361,
930,0.24625748502994013,0,0,930,930,25288,16151,519238,0.1442445828498919,239228,823,0.06976093468445618,46184,329,0,0,329,63158,0.02585533850322584,-30033,0,329,329,0.24625748502994013,329,930,0,0,0,329,930,930,0.1442445828498919,366589,127361,
930,0.24625748502994013,0,0,930,930,25288,16151,519238,0.1442445828498919,239228,823,0.06976093468445618,46184,329,0,0,329,63158,0.02585533850322584,-30033,0,329,329,0.24625748502994013,329,930,0,0,0,329,930,930,0.1442445828498919,366589,127361,
930,0.24625748502994013,0,0,930,930,25288,16151,519238,0.1442445828498919,239228,823,0.06976093468445618,46184,329,0,0,329,63158,0.02585533850322584,-30033,0,329,329,0.24625748502994013,329,930,0,0,0,329,930,930,0.1442445828498919,366589,127361,
930,0.24625748502994013,0,0,930,930,25288,16151,519238,0.1442445828498919,239228,823,0.06976093468445618,46184,329,0,0,329,63158,0.02585533850322584,-30033,0,329,329,0.24625748502994013,329,930,0,0,0,329,930,930,0.1442445828498919,366589,127361,
930,0.24625748502994013,0,0,930,930,25288,16151,519238,0.1442445828498919,239228,823,0.06976093468445618,46184,329,0,0,329,63158,0.02585533850322584,-30033,0,329,329,0.24625748502994013,329,930,0,0,0,329,930,930,0.1442445828498919,366589,127361,
930,0.24625748502994013,0,0,930,930,25288,16151,519238,0.1442445828498919,239228,823,0.06976093468445618,46184,329,0,0,329,63158,0.02585533850322584,-30033,0,329,329,0.24625748502994013,329,930,0,0,0,329,930,930,0.1442445828498919,366589,127361,
930,0.24625748502994013,0,0,930,930,25288,16151,519238,0.1442445828498919,239228,823,0.06976093468445618,46184,329,0,0,329,63158,0.02585533850322584,-30033,0,329,329,0.24625748502994013,329,930,0,0,0,329,930,930,0.1442445828498919,366589,127361,
930,0.24625748502994013,0,0,930,930,25288,16151,519238,0.1442445828498919,239228,823,0.06976093468445618,46184,329,0,0,329,63158,0.02585533850322584,-30033,0,329,329,0.24625748502994013,329,930,0,0,0,329,930,930,0.1442445828498919,366589,127361,
930,0.24625748502994013,0,0,930,930,25288,16151,519238,0.1442445828498919,239228,823,0.06976093468445618,46184,329,0,0,329,63158,0.02585533850322584,-30033,0,329,329,0.24625748502994013,329,930,0,0,0,329,930,930,0.1442445828498919,366589,127361,
930,0.1750788643533123,0,0,930,930,25288,16151,519238,0.1442445828498919,239228,823,0.06976093468445618,46184,333,0,0,333,63158,0.02585533850322584,-30033,0,333,333,0.1750788643533123,333,930,0,0,0,333,930,930,0.1442445828498919,366589,127361,
930,0.1750788643533123,0,0,930,930,25288,16151,519238,0.1442445828498919,239228,823,0.06976093468445618,46184,333,0,0,333,63158,0.02585533850322584,-30033,0,333,333,0.1750788643533123,333,930,0,0,0,333,930,930,0.1442445828498919,366589,127361,
930,0.06005859375,0,0,930,930,25288,16151,519238,0.1442445828498919,239228,823,0.06976093468445618,46184,123,0,0,123,63158,0.02585533850322584,-30033,0,123,123,0.06005859375,123,930,0,0,0,123,930,930,0.1442445828498919,366589,127361,
14,0.1746031746031746,0,10,4,24,25288,16151,519238,0.17903439153439152,239228,823,0.06976093468445618,46184,12,1,0,13,63158,0.02585533850322584,-30033,1,11,10,0.09623015873015872,11,16,0,10,0,9,26,6,0.1529100529100529,366589,127361,
14,0.1746031746031746,0,10,4,24,25288,16151,519238,0.17903439153439152,239228,823,0.06976093468445618,46184,12,1,0,13,63158,0.02585533850322584,-30033,1,11,10,0.09623015873015872,11,16,0,10,0,9,26,6,0.1529100529100529,366589,127361,
14,0.1746031746031746,0,10,4,24,25288,16151,519238,0.17903439153439152,239228,823,0.06976093468445618,46184,12,1,0,13,63158,0.02585533850322584,-30033,1,11,10,0.09623015873015872,11,16,0,10,0,9,26,6,0.1529100529100529,366589,127361,
14,0.1746031746031746,0,10,4,24,25288,16151,519238,0.17903439153439152,239228,823,0.06976093468445618,46184,12,1,0,13,63158,0.02585533850322584,-30033,1,11,10,0.09623015873015872,11,16,0,10,0,9,26,6,0.1529100529100529,366589,127361,
26,0.0,5,6,20,37,25288,16151,519238,0.016494817875833144,239228,823,0.06976093468445618,46184,121,0,0,121,63158,0.02585533850322584,-30033,0,121,0,0.004912708079577751,0,3190,0,88,1257,0,4535,3102,0.0314146153652,366589,127361,
26,0.20925551057130007,5,6,20,37,25288,16151,519238,0.016494817875833144,239228,823,0.06976093468445618,46184,905,77,55,1037,63158,0.02585533850322584,-30033,4,828,15,0.16242219140690378,19,3190,0,88,1257,11,4535,3102,0.0314146153652,366589,127361,
26,0.20925551057130007,5,6,20,37,25288,16151,519238,0.016494817875833144,239228,823,0.06976093468445618,46184,905,77,55,1037,63158,0.02585533850322584,-30033,4,828,15,0.16242219140690378,19,3190,0,88,1257,11,4535,3102,0.0314146153652,366589,127361,
26,0.20925551057130007,5,6,20,37,25288,16151,519238,0.016494817875833144,239228,823,0.06976093468445618,46184,905,77,55,1037,63158,0.02585533850322584,-30033,4,828,15,0.16242219140690378,19,3190,0,88,1257,11,4535,3102,0.0314146153652,366589,127361,
26,0.20925551057130007,5,6,20,37,25288,16151,519238,0.016494817875833144,239228,823,0.06976093468445618,46184,905,77,55,1037,63158,0.02585533850322584,-30033,4,828,15,0.16242219140690378,19,3190,0,88,1257,11,4535,3102,0.0314146153652,366589,127361,
26,0.20925551057130007,5,6,20,37,25288,16151,519238,0.016494817875833144,239228,823,0.06976093468445618,46184,905,77,55,1037,63158,0.02585533850322584,-30033,4,828,15,0.16242219140690378,19,3190,0,88,1257,11,4535,3102,0.0314146153652,366589,127361,
26,0.20925551057130007,5,6,20,37,25288,16151,519238,0.016494817875833144,239228,823,0.06976093468445618,46184,905,77,55,1037,63158,0.02585533850322584,-30033,4,828,15,0.16242219140690378,19,3190,0,88,1257,11,4535,3102,0.0314146153652,366589,127361,
26,0.20925551057130007,5,6,20,37,25288,16151,519238,0.016494817875833144,239228,823,0.06976093468445618,46184,905,77,55,1037,63158,0.02585533850322584,-30033,4,828,15,0.16242219140690378,19,3190,0,88,1257,11,4535,3102,0.0314146153652,366589,127361,
26,0.20925551057130007,5,6,20,37,25288,16151,519238,0.016494817875833144,239228,823,0.06976093468445618,46184,905,77,55,1037,63158,0.02585533850322584,-30033,4,828,15,0.16242219140690378,19,3190,0,88,1257,11,4535,3102,0.0314146153652,366589,127361,
26,0.20925551057130007,5,6,20,37,25288,16151,519238,0.016494817875833144,239228,823,0.06976093468445618,46184,905,77,55,1037,63158,0.02585533850322584,-30033,4,828,15,0.16242219140690378,19,3190,0,88,1257,11,4535,3102,0.0314146153652,366589,127361,
26,0.20925551057130007,5,6,20,37,25288,16151,519238,0.016494817875833144,239228,823,0.06976093468445618,46184,905,77,55,1037,63158,0.02585533850322584,-30033,4,828,15,0.16242219140690378,19,3190,0,88,1257,11,4535,3102,0.0314146153652,366589,127361,
26,0.20925551057130007,5,6,20,37,25288,16151,519238,0.016494817875833144,239228,823,0.06976093468445618,46184,905,77,55,1037,63158,0.02585533850322584,-30033,4,828,15,0.16242219140690378,19,3190,0,88,1257,11,4535,3102,0.0314146153652,366589,127361,
26,0.20925551057130007,5,6,20,37,25288,16151,519238,0.016494817875833144,239228,823,0.06976093468445618,46184,905,77,55,1037,63158,0.02585533850322584,-30033,4,828,15,0.16242219140690378,19,3190,0,88,1257,11,4535,3102,0.0314146153652,366589,127361,
26,0.20925551057130007,5,6,20,37,25288,16151,519238,0.016494817875833144,239228,823,0.06976093468445618,46184,905,77,55,1037,63158,0.02585533850322584,-30033,4,828,15,0.16242219140690378,19,3190,0,88,1257,11,4535,3102,0.0314146153652,366589,127361,
26,0.20925551057130007,5,6,20,37,25288,16151,519238,0.016494817875833144,239228,823,0.06976093468445618,46184,905,77,55,1037,63158,0.02585533850322584,-30033,4,828,15,0.16242219140690378,19,3190,0,88,1257,11,4535,3102,0.0314146153652,366589,127361,
26,0.20925551057130007,5,6,20,37,25288,16151,519238,0.016494817875833144,239228,823,0.06976093468445618,46184,905,77,55,1037,63158,0.02585533850322584,-30033,4,828,15,0.16242219140690378,19,3190,0,88,1257,11,4535,3102,0.0314146153652,366589,127361,
26,0.20925551057130007,5,6,20,37,25288,16151,519238,0.016494817875833144,239228,823,0.06976093468445618,46184,905,77,55,1037,63158,0.02585533850322584,-30033,4,828,15,0.16242219140690378,19,3190,0,88,1257,11,4535,3102,0.0314146153652,366589,127361,
26,0.20925551057130007,5,6,20,37,25288,16151,519238,0.016494817875833144,239228,823,0.06976093468445618,46184,905,77,55,1037,63158,0.02585533850322584,-30033,4,828,15,0.16242219140690378,19,3190,0,88,1257,11,4535,3102,0.0314146153652,366589,127361,
26,0.20925551057130007,5,6,20,37,25288,16151,519238,0.016494817875833144,239228,823,0.06976093468445618,46184,905,77,55,1037,63158,0.02585533850322584,-30033,4,828,15,0.16242219140690378,19,3190,0,88,1257,11,4535,3102,0.0314146153652,366589,127361,
26,0.20925551057130007,5,6,20,37,25288,16151,519238,0.016494817875833144,239228,823,0.06976093468445618,46184,905,77,55,1037,63158,0.02585533850322584,-30033,4,828,15,0.16242219140690378,19,3190,0,88,1257,11,4535,3102,0.0314146153652,366589,127361,
26,0.20925551057130007,5,6,20,37,25288,16151,519238,0.016494817875833144,239228,823,0.06976093468445618,46184,905,77,55,1037,63158,0.02585533850322584,-30033,4,828,15,0.16242219140690378,19,3190,0,88,1257,11,4535,3102,0.0314146153652,366589,127361,
26,0.20925551057130007,5,6,20,37,25288,16151,519238,0.016494817875833144,239228,823,0.06976093468445618,46184,905,77,55,1037,63158,0.02585533850322584,-30033,4,828,15,0.16242219140690378,19,3190,0,88,1257,11,4535,3102,0.0314146153652,366589,127361,
26,0.0,5,6,20,37,25288,16151,519238,0.016494817875833144,239228,823,0.06976093468445618,46184,454,2,2,458,63158,0.02585533850322584,-30033,0,452,0,0.14348214143587423,0,3190,0,88,1257,0,4535,3102,0.0314146153652,366589,127361,
26,0.0,5,6,20,37,25288,16151,519238,0.016494817875833144,239228,823,0.06976093468445618,46184,454,2,2,458,63158,0.02585533850322584,-30033,0,452,0,0.14348214143587423,0,3190,0,88,1257,0,4535,3102,0.0314146153652,366589,127361,
26,0.045454545454545456,5,6,20,37,25288,16151,519238,0.016494817875833144,239228,823,0.06976093468445618,46184,13,2,0,15,63158,0.02585533850322584,-30033,0,11,2,0.12141972610722611,2,3190,0,88,1257,2,4535,3102,0.0314146153652,366589,127361,
26,0.045454545454545456,5,6,20,37,25288,16151,519238,0.016494817875833144,239228,823,0.06976093468445618,46184,13,2,0,15,63158,0.02585533850322584,-30033,0,11,2,0.12141972610722611,2,3190,0,88,1257,2,4535,3102,0.0314146153652,366589,127361,
26,0.045454545454545456,5,6,20,37,25288,16151,519238,0.016494817875833144,239228,823,0.06976093468445618,46184,13,2,0,15,63158,0.02585533850322584,-30033,0,11,2,0.12141972610722611,2,3190,0,88,1257,2,4535,3102,0.0314146153652,366589,127361,
26,0.0,5,6,20,37,25288,16151,519238,0.016494817875833144,239228,823,0.06976093468445618,46184,0,0,207,207,63158,0.02585533850322584,-30033,0,0,0,0.009061063690085358,0,3190,0,88,1257,0,4535,3102,0.0314146153652,366589,127361,
26,0.0,5,6,20,37,25288,16151,519238,0.016494817875833144,239228,823,0.06976093468445618,46184,0,0,207,207,63158,0.02585533850322584,-30033,0,0,0,0.009061063690085358,0,3190,0,88,1257,0,4535,3102,0.0314146153652,366589,127361,
26,0.0,5,6,20,37,25288,16151,519238,0.016494817875833144,239228,823,0.06976093468445618,46184,0,0,207,207,63158,0.02585533850322584,-30033,0,0,0,0.009061063690085358,0,3190,0,88,1257,0,4535,3102,0.0314146153652,366589,127361,
26,0.0,5,6,20,37,25288,16151,519238,0.016494817875833144,239228,823,0.06976093468445618,46184,0,0,207,207,63158,0.02585533850322584,-30033,0,0,0,0.009061063690085358,0,3190,0,88,1257,0,4535,3102,0.0314146153652,366589,127361,
26,0.0,5,6,20,37,25288,16151,519238,0.016494817875833144,239228,823,0.06976093468445618,46184,0,0,207,207,63158,0.02585533850322584,-30033,0,0,0,0.009061063690085358,0,3190,0,88,1257,0,4535,3102,0.0314146153652,366589,127361,
26,0.0,5,6,20,37,25288,16151,519238,0.016494817875833144,239228,823,0.06976093468445618,46184,0,0,207,207,63158,0.02585533850322584,-30033,0,0,0,0.009061063690085358,0,3190,0,88,1257,0,4535,3102,0.0314146153652,366589,127361,
26,0.0,5,6,20,37,25288,16151,519238,0.016494817875833144,239228,823,0.06976093468445618,46184,174,0,0,174,63158,0.02585533850322584,-30033,0,174,0,0.02021136127831145,0,3190,0,88,1257,0,4535,3102,0.0314146153652,366589,127361,
26,0.0,5,6,20,37,25288,16151,519238,0.016494817875833144,239228,823,0.06976093468445618,46184,0,0,88,88,63158,0.02585533850322584,-30033,0,0,0,0.003735144312393888,0,3190,0,88,1257,0,4535,3102,0.0314146153652,366589,127361,
26,0.37209302325581395,5,6,20,37,25288,16151,519238,0.016494817875833144,239228,823,0.06976093468445618,46184,659,7,611,1277,63158,0.02585533850322584,-30033,2,652,9,0.14921392504217548,16,3190,5,88,1257,7,4535,3102,0.0314146153652,366589,127361,
26,0.37209302325581395,5,6,20,37,25288,16151,519238,0.016494817875833144,239228,823,0.06976093468445618,46184,659,7,611,1277,63158,0.02585533850322584,-30033,2,652,9,0.14921392504217548,16,3190,5,88,1257,7,4535,3102,0.0314146153652,366589,127361,
26,0.37209302325581395,5,6,20,37,25288,16151,519238,0.016494817875833144,239228,823,0.06976093468445618,46184,659,7,611,1277,63158,0.02585533850322584,-30033,2,652,9,0.14921392504217548,16,3190,5,88,1257,7,4535,3102,0.0314146153652,366589,127361,
26,0.37209302325581395,5,6,20,37,25288,16151,519238,0.016494817875833144,239228,823,0.06976093468445618,46184,659,7,611,1277,63158,0.02585533850322584,-30033,2,652,9,0.14921392504217548,16,3190,5,88,1257,7,4535,3102,0.0314146153652,366589,127361,
0,0.0,0,0,0,0,25288,16151,519238,0.0,239228,823,0.06976093468445618,46184,7,0,1,8,63158,0.02585533850322584,-30033,0,7,0,0.009569377990430622,0,1140,0,8,1,0,1149,1132,0.009613015301175344,366589,127361,
4,0.17054263565891473,15,5,-1,24,25288,16151,519238,0.009375314607872748,239228,823,0.06976093468445618,46184,129,4,15,148,63158,0.02585533850322584,-30033,4,125,3,0.08738491530656006,22,217,15,5,619,-1,841,212,0.005865182813219566,366589,127361,
4,0.17054263565891473,15,5,-1,24,25288,16151,519238,0.009375314607872748,239228,823,0.06976093468445618,46184,129,4,15,148,63158,0.02585533850322584,-30033,4,125,3,0.08738491530656006,22,217,15,5,619,-1,841,212,0.005865182813219566,366589,127361,
4,0.17054263565891473,15,5,-1,24,25288,16151,519238,0.009375314607872748,239228,823,0.06976093468445618,46184,129,4,15,148,63158,0.02585533850322584,-30033,4,125,3,0.08738491530656006,22,217,15,5,619,-1,841,212,0.005865182813219566,366589,127361,
4,0.03571428571428571,15,5,-1,24,25288,16151,519238,0.009375314607872748,239228,823,0.06976093468445618,46184,71,1,0,72,63158,0.02585533850322584,-30033,1,70,1,0.019013785289396658,2,217,0,5,619,0,841,212,0.005865182813219566,366589,127361,
4,0.03571428571428571,15,5,-1,24,25288,16151,519238,0.009375314607872748,239228,823,0.06976093468445618,46184,71,1,0,72,63158,0.02585533850322584,-30033,1,70,1,0.019013785289396658,2,217,0,5,619,0,841,212,0.005865182813219566,366589,127361,
4,0.0,15,5,-1,24,25288,16151,519238,0.009375314607872748,239228,823,0.06976093468445618,46184,0,0,109,109,63158,0.02585533850322584,-30033,0,0,0,0.003999853216395729,0,217,0,5,619,0,841,212,0.005865182813219566,366589,127361,
4,0.0,15,5,-1,24,25288,16151,519238,0.009375314607872748,239228,823,0.06976093468445618,46184,0,0,121,121,63158,0.02585533850322584,-30033,0,0,0,0.004391376932568774,0,217,0,5,619,0,841,212,0.005865182813219566,366589,127361,
4,0.0,15,5,-1,24,25288,16151,519238,0.009375314607872748,239228,823,0.06976093468445618,46184,0,0,130,130,63158,0.02585533850322584,-30033,0,0,0,0.004662339059642076,0,217,0,5,619,0,841,212,0.005865182813219566,366589,127361,
4,0.0,15,5,-1,24,25288,16151,519238,0.009375314607872748,239228,823,0.06976093468445618,46184,0,0,108,108,63158,0.02585533850322584,-30033,0,0,0,0.0038363171355498722,0,217,0,5,619,0,841,212,0.005865182813219566,366589,127361,
0,0.0,0,0,0,0,25288,16151,519238,0.0,239228,823,0.06976093468445618,46184,11,0,0,11,63158,0.02585533850322584,-30033,0,11,0,3.498950314905528E-4,0,1170,0,3,0,0,1173,1167,0.002742509568529105,366589,127361,
0,0.0,0,0,0,0,25288,16151,519238,0.0,239228,823,0.06976093468445618,46184,11,0,0,11,63158,0.02585533850322584,-30033,0,11,0,3.461078597948524E-4,0,1170,0,3,0,0,1173,1167,0.002742509568529105,366589,127361,
0,0.0,0,0,0,0,25288,16151,519238,0.0,239228,823,0.06976093468445618,46184,11,0,0,11,63158,0.02585533850322584,-30033,0,11,0,3.455425017277125E-4,0,1170,0,3,0,0,1173,1167,0.002742509568529105,366589,127361,
0,0.0,0,0,0,0,25288,16151,519238,0.0,239228,823,0.06976093468445618,46184,11,0,0,11,63158,0.02585533850322584,-30033,0,11,0,3.449789876434799E-4,0,1170,0,3,0,0,1173,1167,0.002742509568529105,366589,127361,
0,0.0,0,0,0,0,25288,16151,519238,0.0,239228,823,0.06976093468445618,46184,11,0,0,11,63158,0.02585533850322584,-30033,0,11,0,3.4441730853528713E-4,0,1170,0,3,0,0,1173,1167,0.002742509568529105,366589,127361,
0,0.0,0,0,0,0,25288,16151,519238,0.0,239228,823,0.06976093468445618,46184,238,0,0,238,63158,0.02585533850322584,-30033,0,238,0,0.007185773376407717,0,1170,0,3,0,0,1173,1167,0.002742509568529105,366589,127361,
0,0.0,0,0,0,0,25288,16151,519238,0.0,239228,823,0.06976093468445618,46184,238,0,0,238,63158,0.02585533850322584,-30033,0,238,0,0.007185773376407717,0,1170,0,3,0,0,1173,1167,0.002742509568529105,366589,127361,
0,0.0,0,0,0,0,25288,16151,519238,0.0,239228,823,0.06976093468445618,46184,238,0,0,238,63158,0.02585533850322584,-30033,0,238,0,0.007185773376407717,0,1170,0,3,0,0,1173,1167,0.002742509568529105,366589,127361,
0,0.0,0,0,0,0,25288,16151,519238,0.0,239228,823,0.06976093468445618,46184,238,0,0,238,63158,0.02585533850322584,-30033,0,238,0,0.007185773376407717,0,1170,0,3,0,0,1173,1167,0.002742509568529105,366589,127361,
0,0.0,0,0,0,0,25288,16151,519238,0.0,239228,823,0.06976093468445618,46184,11,0,0,11,63158,0.02585533850322584,-30033,0,11,0,3.2990432774495396E-4,0,1170,0,3,0,0,1173,1167,0.002742509568529105,366589,127361,
0,0.0,0,0,0,0,25288,16151,519238,0.0,239228,823,0.06976093468445618,46184,200,2,0,202,63158,0.02585533850322584,-30033,0,198,0,0.027635245740650797,0,1170,0,3,0,0,1173,1167,0.002742509568529105,366589,127361,
0,0.0,0,0,0,0,25288,16151,519238,0.0,239228,823,0.06976093468445618,46184,200,2,0,202,63158,0.02585533850322584,-30033,0,198,0,0.027635245740650797,0,1170,0,3,0,0,1173,1167,0.002742509568529105,366589,127361,
0,0.0,0,0,0,0,25288,16151,519238,0.0,239228,823,0.06976093468445618,46184,200,2,0,202,63158,0.02585533850322584,-30033,0,198,0,0.027635245740650797,0,1170,0,3,0,0,1173,1167,0.002742509568529105,366589,127361,
0,0.0,0,0,0,0,25288,16151,519238,0.0,239228,823,0.06976093468445618,46184,200,2,0,202,63158,0.02585533850322584,-30033,0,198,0,0.027635245740650797,0,1170,0,3,0,0,1173,1167,0.002742509568529105,366589,127361,
0,0.0,0,0,0,0,25288,16151,519238,0.0,239228,823,0.06976093468445618,46184,1,1,0,2,63158,0.02585533850322584,-30033,0,0,0,0.0196078431372549,0,1170,0,3,0,0,1173,1167,0.002742509568529105,366589,127361,
0,0.0,0,0,0,0,25288,16151,519238,0.0,239228,823,0.06976093468445618,46184,1,1,0,2,63158,0.02585533850322584,-30033,0,0,0,0.0196078431372549,0,1170,0,3,0,0,1173,1167,0.002742509568529105,366589,127361,
0,0.0,0,0,0,0,25288,16151,519238,0.0,239228,823,0.06976093468445618,46184,1,1,0,2,63158,0.02585533850322584,-30033,0,0,0,0.0196078431372549,0,1170,0,3,0,0,1173,1167,0.002742509568529105,366589,127361,
0,0.0,0,0,0,0,25288,16151,519238,0.0,239228,823,0.06976093468445618,46184,2,1,0,3,63158,0.02585533850322584,-30033,0,1,0,0.012448132780082987,0,2759,0,12,0,0,2771,2747,0.010777544409978074,366589,127361,
0,0.0,0,0,0,0,25288,16151,519238,0.0,239228,823,0.06976093468445618,46184,24,0,0,24,63158,0.02585533850322584,-30033,0,24,0,6.929206605843631E-4,0,2759,0,12,0,0,2771,2747,0.010777544409978074,366589,127361,
0,0.0,0,0,0,0,25288,16151,519238,0.0,239228,823,0.06976093468445618,46184,28,0,0,28,63158,0.02585533850322584,-30033,0,28,0,7.973346242560583E-4,0,2759,0,12,0,0,2771,2747,0.010777544409978074,366589,127361,
0,0.0,0,0,0,0,25288,16151,519238,0.0,239228,823,0.06976093468445618,46184,28,0,0,28,63158,0.02585533850322584,-30033,0,28,0,7.922360863537334E-4,0,2759,0,12,0,0,2771,2747,0.010777544409978074,366589,127361,
0,0.0,0,0,0,0,25288,16151,519238,0.0,239228,823,0.06976093468445618,46184,28,0,0,28,63158,0.02585533850322584,-30033,0,28,0,7.904915163321194E-4,0,2759,0,12,0,0,2771,2747,0.010777544409978074,366589,127361,
0,0.0,0,0,0,0,25288,16151,519238,0.0,239228,823,0.06976093468445618,46184,28,0,0,28,63158,0.02585533850322584,-30033,0,28,0,7.822321553289565E-4,0,2759,0,12,0,0,2771,2747,0.010777544409978074,366589,127361,
0,0.0,0,0,0,0,25288,16151,519238,0.0,239228,823,0.06976093468445618,46184,68,0,0,68,63158,0.02585533850322584,-30033,0,68,0,0.0017619775606975358,0,2759,0,12,0,0,2771,2747,0.010777544409978074,366589,127361,
0,0.0,0,0,0,0,25288,16151,519238,0.0,239228,823,0.06976093468445618,46184,2,1,0,3,63158,0.02585533850322584,-30033,0,1,0,0.011673151750972763,0,2759,0,12,0,0,2771,2747,0.010777544409978074,366589,127361,
0,0.0,0,0,0,0,25288,16151,519238,0.0,239228,823,0.06976093468445618,46184,28,0,0,28,63158,0.02585533850322584,-30033,0,28,0,7.161857990587272E-4,0,2759,0,12,0,0,2771,2747,0.010777544409978074,366589,127361,
1,0.0,0,1,0,2,25288,16151,519238,0.002347417840375587,239228,823,0.06976093468445618,46184,66,0,0,66,63158,0.02585533850322584,-30033,0,66,0,0.0016220998820290994,0,282,0,1,0,0,283,281,0.0022590541236856116,366589,127361,
1,0.014084507042253521,0,1,0,2,25288,16151,519238,0.002347417840375587,239228,823,0.06976093468445618,46184,33,1,0,34,63158,0.02585533850322584,-30033,1,32,1,0.007434718199305725,2,282,0,1,0,0,283,281,0.0022590541236856116,366589,127361,
1,0.014084507042253521,0,1,0,2,25288,16151,519238,0.002347417840375587,239228,823,0.06976093468445618,46184,33,1,0,34,63158,0.02585533850322584,-30033,1,32,1,0.007434718199305725,2,282,0,1,0,0,283,281,0.0022590541236856116,366589,127361,
0,0.0,0,0,0,0,25288,16151,519238,0.0,239228,823,0.06976093468445618,46184,48,0,0,48,63158,0.02585533850322584,-30033,0,48,0,0.0011691917961708968,0,779,0,0,0,0,779,779,0.0018667268276749474,366589,127361,
0,0.0,0,0,0,0,25288,16151,519238,0.0,239228,823,0.06976093468445618,46184,54,0,0,54,63158,0.02585533850322584,-30033,0,54,0,0.0012964252274746118,0,779,0,0,0,0,779,779,0.0018667268276749474,366589,127361,
0,0.0,0,0,0,0,25288,16151,519238,0.0,239228,823,0.06976093468445618,46184,68,0,0,68,63158,0.02585533850322584,-30033,0,68,0,0.0016213251949166686,0,779,0,0,0,0,779,779,0.0018667268276749474,366589,127361,
0,0.0,0,0,0,0,25288,16151,519238,0.0,239228,823,0.06976093468445618,46184,48,0,0,48,63158,0.02585533850322584,-30033,0,48,0,0.0011371712864250178,0,779,0,0,0,0,779,779,0.0018667268276749474,366589,127361,
0,0.0,0,0,0,0,25288,16151,519238,0.0,239228,823,0.06976093468445618,46184,28,0,0,28,63158,0.02585533850322584,-30033,0,28,0,6.597238584421093E-4,0,373,0,0,0,0,373,373,0.0010880764060375303,366589,127361,
0,0.0,0,0,0,0,25288,16151,519238,0.0,239228,823,0.06976093468445618,46184,28,0,0,28,63158,0.02585533850322584,-30033,0,28,0,6.597238584421093E-4,0,373,0,0,0,0,373,373,0.0010880764060375303,366589,127361,
0,0.0,0,0,0,0,25288,16151,519238,0.0,239228,823,0.06976093468445618,46184,70,0,0,70,63158,0.02585533850322584,-30033,0,70,0,0.0016213461805716404,0,373,0,0,0,0,373,373,0.0010880764060375303,366589,127361,
0,0.0,0,0,0,0,25288,16151,519238,0.0,239228,823,0.06976093468445618,46184,65,0,0,65,63158,0.02585533850322584,-30033,0,65,0,0.0015012587477192414,0,764,0,0,0,0,764,764,0.0017384622566649598,366589,127361,
0,0.0,0,0,0,0,25288,16151,519238,0.0,239228,823,0.06976093468445618,46184,48,0,0,48,63158,0.02585533850322584,-30033,0,48,0,0.0011019789705679784,0,764,0,0,0,0,764,764,0.0017384622566649598,366589,127361,
0,0.0,0,0,0,0,25288,16151,519238,0.0,239228,823,0.06976093468445618,46184,48,0,0,48,63158,0.02585533850322584,-30033,0,48,0,0.0010954152308359387,0,764,0,0,0,0,764,764,0.0017384622566649598,366589,127361,
0,0.0,0,0,0,0,25288,16151,519238,0.0,239228,823,0.06976093468445618,46184,68,0,0,68,63158,0.02585533850322584,-30033,0,68,0,0.0015417053982361077,0,764,0,0,0,0,764,764,0.0017384622566649598,366589,127361,
0,0.0,0,0,0,0,25288,16151,519238,0.0,239228,823,0.06976093468445618,46184,68,0,0,68,63158,0.02585533850322584,-30033,0,68,0,0.001531428056662838,0,764,0,0,0,0,764,764,0.0017384622566649598,366589,127361,
0,0.0,0,0,0,0,25288,16151,519238,0.0,239228,823,0.06976093468445618,46184,2,2,0,4,63158,0.02585533850322584,-30033,0,0,0,0.030303030303030304,0,1140,0,8,1,0,1149,1132,0.009613015301175344,366589,127361,
0,0.0,0,0,0,0,25288,16151,519238,0.0,239228,823,0.06976093468445618,46184,2,2,0,4,63158,0.02585533850322584,-30033,0,0,0,0.030303030303030304,0,1140,0,8,1,0,1149,1132,0.009613015301175344,366589,127361,
0,0.0,0,0,0,0,25288,16151,519238,0.0,239228,823,0.06976093468445618,46184,2,2,0,4,63158,0.02585533850322584,-30033,0,0,0,0.030303030303030304,0,1140,0,8,1,0,1149,1132,0.009613015301175344,366589,127361,
0,0.0,0,0,0,0,25288,16151,519238,0.0,239228,823,0.06976093468445618,46184,2,2,0,4,63158,0.02585533850322584,-30033,0,0,0,0.030303030303030304,0,1140,0,8,1,0,1149,1132,0.009613015301175344,366589,127361,
0,0.0,0,0,0,0,25288,16151,519238,0.0,239228,823,0.06976093468445618,46184,2,2,0,4,63158,0.02585533850322584,-30033,0,0,0,0.024691358024691357,0,1140,0,8,1,0,1149,1132,0.009613015301175344,366589,127361,
0,0.0,0,0,0,0,25288,16151,519238,0.0,239228,823,0.06976093468445618,46184,2,2,0,4,63158,0.02585533850322584,-30033,0,0,0,0.024691358024691357,0,1140,0,8,1,0,1149,1132,0.009613015301175344,366589,127361,
0,0.0,0,0,0,0,25288,16151,519238,0.0,239228,823,0.06976093468445618,46184,2,2,0,4,63158,0.02585533850322584,-30033,0,0,0,0.024691358024691357,0,1140,0,8,1,0,1149,1132,0.009613015301175344,366589,127361,
0,0.0,0,0,0,0,25288,16151,519238,0.0,239228,823,0.06976093468445618,46184,2,2,0,4,63158,0.02585533850322584,-30033,0,0,0,0.024691358024691357,0,1140,0,8,1,0,1149,1132,0.009613015301175344,366589,127361,
0,0.0,0,0,0,0,25288,16151,519238,0.0,239228,823,0.06976093468445618,46184,4,4,0,8,63158,0.02585533850322584,-30033,0,0,0,0.0380952380952381,0,1140,0,8,1,0,1149,1132,0.009613015301175344,366589,127361,
0,0.0,0,0,0,0,25288,16151,519238,0.0,239228,823,0.06976093468445618,46184,4,4,0,8,63158,0.02585533850322584,-30033,0,0,0,0.0380952380952381,0,1140,0,8,1,0,1149,1132,0.009613015301175344,366589,127361,
0,0.0,0,0,0,0,25288,16151,519238,0.0,239228,823,0.06976093468445618,46184,4,4,0,8,63158,0.02585533850322584,-30033,0,0,0,0.0380952380952381,0,1140,0,8,1,0,1149,1132,0.009613015301175344,366589,127361,
0,0.0,0,0,0,0,25288,16151,519238,0.0,239228,823,0.06976093468445618,46184,4,4,0,8,63158,0.02585533850322584,-30033,0,0,0,0.0380952380952381,0,1140,0,8,1,0,1149,1132,0.009613015301175344,366589,127361,
0,0.0,0,0,0,0,25288,16151,519238,0.0,239228,823,0.06976093468445618,46184,4,4,0,8,63158,0.02585533850322584,-30033,0,0,0,0.0380952380952381,0,1140,0,8,1,0,1149,1132,0.009613015301175344,366589,127361,
0,0.0,0,0,0,0,25288,16151,519238,0.0,239228,823,0.06976093468445618,46184,4,4,0,8,63158,0.02585533850322584,-30033,0,0,0,0.0380952380952381,0,1140,0,8,1,0,1149,1132,0.009613015301175344,366589,127361,
0,0.0,0,0,0,0,25288,16151,519238,0.0,239228,823,0.06976093468445618,46184,4,4,0,8,63158,0.02585533850322584,-30033,0,0,0,0.0380952380952381,0,1140,0,8,1,0,1149,1132,0.009613015301175344,366589,127361,
0,0.0,0,0,0,0,25288,16151,519238,0.0,239228,823,0.06976093468445618,46184,4,4,0,8,63158,0.02585533850322584,-30033,0,0,0,0.0380952380952381,0,1140,0,8,1,0,1149,1132,0.009613015301175344,366589,127361,
0,0.0,0,0,0,0,25288,16151,519238,0.0,239228,823,0.06976093468445618,46184,48,0,0,48,63158,0.02585533850322584,-30033,0,48,0,9.794519150325464E-4,0,2902,0,0,0,0,2902,2902,0.027296044110756108,366589,127361,
0,0.0,0,0,0,0,25288,16151,519238,0.0,239228,823,0.06976093468445618,46184,48,0,0,48,63158,0.02585533850322584,-30033,0,48,0,9.593284700709503E-4,0,2902,0,0,0,0,2902,2902,0.027296044110756108,366589,127361,
1031,0.19230769230769232,58,1128,-97,2217,25288,16151,519238,0.0554864719791916,239228,823,0.06976093468445618,46184,598,56,15,669,63158,0.02585533850322584,-30033,1,542,4,0.19161599217437444,5,18991,0,5988,2458,3,27437,13003,0.09806308064906054,366589,127361,
1031,0.19230769230769232,58,1128,-97,2217,25288,16151,519238,0.0554864719791916,239228,823,0.06976093468445618,46184,598,56,15,669,63158,0.02585533850322584,-30033,1,542,4,0.19161599217437444,5,18991,0,5988,2458,3,27437,13003,0.09806308064906054,366589,127361,
1031,0.19230769230769232,58,1128,-97,2217,25288,16151,519238,0.0554864719791916,239228,823,0.06976093468445618,46184,598,56,15,669,63158,0.02585533850322584,-30033,1,542,4,0.19161599217437444,5,18991,0,5988,2458,3,27437,13003,0.09806308064906054,366589,127361,
1031,0.20112471773493137,58,1128,-97,2217,25288,16151,519238,0.0554864719791916,239228,823,0.06976093468445618,46184,2432,664,215,3311,63158,0.02585533850322584,-30033,23,1768,32,0.14165295692358013,62,18991,7,5988,2458,9,27437,13003,0.09806308064906054,366589,127361,
1031,0.20112471773493137,58,1128,-97,2217,25288,16151,519238,0.0554864719791916,239228,823,0.06976093468445618,46184,2432,664,215,3311,63158,0.02585533850322584,-30033,23,1768,32,0.14165295692358013,62,18991,7,5988,2458,9,27437,13003,0.09806308064906054,366589,127361,
1031,0.20112471773493137,58,1128,-97,2217,25288,16151,519238,0.0554864719791916,239228,823,0.06976093468445618,46184,2432,664,215,3311,63158,0.02585533850322584,-30033,23,1768,32,0.14165295692358013,62,18991,7,5988,2458,9,27437,13003,0.09806308064906054,366589,127361,
1031,0.20112471773493137,58,1128,-97,2217,25288,16151,519238,0.0554864719791916,239228,823,0.06976093468445618,46184,2432,664,215,3311,63158,0.02585533850322584,-30033,23,1768,32,0.14165295692358013,62,18991,7,5988,2458,9,27437,13003,0.09806308064906054,366589,127361,
1031,0.20112471773493137,58,1128,-97,2217,25288,16151,519238,0.0554864719791916,239228,823,0.06976093468445618,46184,2432,664,215,3311,63158,0.02585533850322584,-30033,23,1768,32,0.14165295692358013,62,18991,7,5988,2458,9,27437,13003,0.09806308064906054,366589,127361,
1031,0.007593014426727411,58,1128,-97,2217,25288,16151,519238,0.0554864719791916,239228,823,0.06976093468445618,46184,276,50,23,349,63158,0.02585533850322584,-30033,0,226,10,0.11807461842119922,10,18991,0,5988,2458,10,27437,13003,0.09806308064906054,366589,127361,
1031,0.0770920606649886,58,1128,-97,2217,25288,16151,519238,0.0554864719791916,239228,823,0.06976093468445618,46184,334,74,7,415,63158,0.02585533850322584,-30033,13,260,22,0.09979330520559572,35,18991,0,5988,2458,9,27437,13003,0.09806308064906054,366589,127361,
1031,0.32075471698113206,58,1128,-97,2217,25288,16151,519238,0.0554864719791916,239228,823,0.06976093468445618,46184,558,48,22,628,63158,0.02585533850322584,-30033,1,510,33,0.14108691089948444,34,18991,0,5988,2458,32,27437,13003,0.09806308064906054,366589,127361,
1031,0.32075471698113206,58,1128,-97,2217,25288,16151,519238,0.0554864719791916,239228,823,0.06976093468445618,46184,558,48,22,628,63158,0.02585533850322584,-30033,1,510,33,0.14108691089948444,34,18991,0,5988,2458,32,27437,13003,0.09806308064906054,366589,127361,
1031,0.32075471698113206,58,1128,-97,2217,25288,16151,519238,0.0554864719791916,239228,823,0.06976093468445618,46184,558,48,22,628,63158,0.02585533850322584,-30033,1,510,33,0.14108691089948444,34,18991,0,5988,2458,32,27437,13003,0.09806308064906054,366589,127361,
1031,0.40268456375838924,58,1128,-97,2217,25288,16151,519238,0.0554864719791916,239228,823,0.06976093468445618,46184,502,219,24,745,63158,0.02585533850322584,-30033,13,283,107,0.1418247594705799,120,18991,0,5988,2458,94,27437,13003,0.09806308064906054,366589,127361,
1031,0.0,58,1128,-97,2217,25288,16151,519238,0.0554864719791916,239228,823,0.06976093468445618,46184,27,0,0,27,63158,0.02585533850322584,-30033,0,27,0,0.12272727272727273,0,18991,0,5988,2458,0,27437,13003,0.09806308064906054,366589,127361,
1031,0.2243835616438356,58,1128,-97,2217,25288,16151,519238,0.0554864719791916,239228,823,0.06976093468445618,46184,757,267,50,1074,63158,0.02585533850322584,-30033,3,490,65,0.15919787214931078,69,18991,1,5988,2458,62,27437,13003,0.09806308064906054,366589,127361,
1031,0.2243835616438356,58,1128,-97,2217,25288,16151,519238,0.0554864719791916,239228,823,0.06976093468445618,46184,757,267,50,1074,63158,0.02585533850322584,-30033,3,490,65,0.15919787214931078,69,18991,1,5988,2458,62,27437,13003,0.09806308064906054,366589,127361,
1031,0.2243835616438356,58,1128,-97,2217,25288,16151,519238,0.0554864719791916,239228,823,0.06976093468445618,46184,757,267,50,1074,63158,0.02585533850322584,-30033,3,490,65,0.15919787214931078,69,18991,1,5988,2458,62,27437,13003,0.09806308064906054,366589,127361,
1031,0.002577319587628866,58,1128,-97,2217,25288,16151,519238,0.0554864719791916,239228,823,0.06976093468445618,46184,103,18,4,125,63158,0.02585533850322584,-30033,0,85,1,0.005054096713437767,1,18991,0,5988,2458,1,27437,13003,0.09806308064906054,366589,127361,
1031,0.037037037037037035,58,1128,-97,2217,25288,16151,519238,0.0554864719791916,239228,823,0.06976093468445618,46184,206,26,4,236,63158,0.02585533850322584,-30033,0,180,4,0.06572035833232161,4,18991,0,5988,2458,4,27437,13003,0.09806308064906054,366589,127361,
1031,0.0,58,1128,-97,2217,25288,16151,519238,0.0554864719791916,239228,823,0.06976093468445618,46184,45,10,23,78,63158,0.02585533850322584,-30033,0,35,0,0.1158749428497133,0,18991,0,5988,2458,0,27437,13003,0.09806308064906054,366589,127361,
1031,0.009969816152931492,58,1128,-97,2217,25288,16151,519238,0.0554864719791916,239228,823,0.06976093468445618,46184,240,125,0,365,63158,0.02585533850322584,-30033,109,115,0,0.16600827992557213,109,18991,0,5988,2458,-109,27437,13003,0.09806308064906054,366589,127361,
1031,0.009969816152931492,58,1128,-97,2217,25288,16151,519238,0.0554864719791916,239228,823,0.06976093468445618,46184,240,125,0,365,63158,0.02585533850322584,-30033,109,115,0,0.16600827992557213,109,18991,0,5988,2458,-109,27437,13003,0.09806308064906054,366589,127361,
1031,0.0,58,1128,-97,2217,25288,16151,519238,0.0554864719791916,239228,823,0.06976093468445618,46184,36,5,0,41,63158,0.02585533850322584,-30033,0,31,0,0.24681556794740678,0,18991,0,5988,2458,0,27437,13003,0.09806308064906054,366589,127361,
1031,0.0,58,1128,-97,2217,25288,16151,519238,0.0554864719791916,239228,823,0.06976093468445618,46184,36,5,0,41,63158,0.02585533850322584,-30033,0,31,0,0.24681556794740678,0,18991,0,5988,2458,0,27437,13003,0.09806308064906054,366589,127361,
1031,0.07095219445615132,58,1128,-97,2217,25288,16151,519238,0.0554864719791916,239228,823,0.06976093468445618,46184,4219,1356,1394,6969,63158,0.02585533850322584,-30033,65,2863,70,0.1760003726582123,135,18991,0,5988,2458,5,27437,13003,0.09806308064906054,366589,127361,
1031,0.07095219445615132,58,1128,-97,2217,25288,16151,519238,0.0554864719791916,239228,823,0.06976093468445618,46184,4219,1356,1394,6969,63158,0.02585533850322584,-30033,65,2863,70,0.1760003726582123,135,18991,0,5988,2458,5,27437,13003,0.09806308064906054,366589,127361,
1031,0.07095219445615132,58,1128,-97,2217,25288,16151,519238,0.0554864719791916,239228,823,0.06976093468445618,46184,4219,1356,1394,6969,63158,0.02585533850322584,-30033,65,2863,70,0.1760003726582123,135,18991,0,5988,2458,5,27437,13003,0.09806308064906054,366589,127361,
1031,0.07095219445615132,58,1128,-97,2217,25288,16151,519238,0.0554864719791916,239228,823,0.06976093468445618,46184,4219,1356,1394,6969,63158,0.02585533850322584,-30033,65,2863,70,0.1760003726582123,135,18991,0,5988,2458,5,27437,13003,0.09806308064906054,366589,127361,
1031,0.09027271053958734,58,1128,-97,2217,25288,16151,519238,0.0554864719791916,239228,823,0.06976093468445618,46184,1034,509,151,1694,63158,0.02585533850322584,-30033,153,525,40,0.18305247272248304,207,18991,14,5988,2458,-113,27437,13003,0.09806308064906054,366589,127361,
1031,0.09027271053958734,58,1128,-97,2217,25288,16151,519238,0.0554864719791916,239228,823,0.06976093468445618,46184,1034,509,151,1694,63158,0.02585533850322584,-30033,153,525,40,0.18305247272248304,207,18991,14,5988,2458,-113,27437,13003,0.09806308064906054,366589,127361,
1031,0.09027271053958734,58,1128,-97,2217,25288,16151,519238,0.0554864719791916,239228,823,0.06976093468445618,46184,1034,509,151,1694,63158,0.02585533850322584,-30033,153,525,40,0.18305247272248304,207,18991,14,5988,2458,-113,27437,13003,0.09806308064906054,366589,127361,
1031,0.09027271053958734,58,1128,-97,2217,25288,16151,519238,0.0554864719791916,239228,823,0.06976093468445618,46184,1034,509,151,1694,63158,0.02585533850322584,-30033,153,525,40,0.18305247272248304,207,18991,14,5988,2458,-113,27437,13003,0.09806308064906054,366589,127361,
1031,0.29245283018867924,58,1128,-97,2217,25288,16151,519238,0.0554864719791916,239228,823,0.06976093468445618,46184,701,64,0,765,63158,0.02585533850322584,-30033,47,637,15,0.15246195718489078,62,18991,0,5988,2458,-32,27437,13003,0.09806308064906054,366589,127361,
1031,0.29245283018867924,58,1128,-97,2217,25288,16151,519238,0.0554864719791916,239228,823,0.06976093468445618,46184,701,64,0,765,63158,0.02585533850322584,-30033,47,637,15,0.15246195718489078,62,18991,0,5988,2458,-32,27437,13003,0.09806308064906054,366589,127361,
1031,0.29245283018867924,58,1128,-97,2217,25288,16151,519238,0.0554864719791916,239228,823,0.06976093468445618,46184,701,64,0,765,63158,0.02585533850322584,-30033,47,637,15,0.15246195718489078,62,18991,0,5988,2458,-32,27437,13003,0.09806308064906054,366589,127361,
1031,0.29245283018867924,58,1128,-97,2217,25288,16151,519238,0.0554864719791916,239228,823,0.06976093468445618,46184,701,64,0,765,63158,0.02585533850322584,-30033,47,637,15,0.15246195718489078,62,18991,0,5988,2458,-32,27437,13003,0.09806308064906054,366589,127361,
1031,0.29245283018867924,58,1128,-97,2217,25288,16151,519238,0.0554864719791916,239228,823,0.06976093468445618,46184,701,64,0,765,63158,0.02585533850322584,-30033,47,637,15,0.15246195718489078,62,18991,0,5988,2458,-32,27437,13003,0.09806308064906054,366589,127361,
1031,0.29245283018867924,58,1128,-97,2217,25288,16151,519238,0.0554864719791916,239228,823,0.06976093468445618,46184,701,64,0,765,63158,0.02585533850322584,-30033,47,637,15,0.15246195718489078,62,18991,0,5988,2458,-32,27437,13003,0.09806308064906054,366589,127361,
1031,0.29245283018867924,58,1128,-97,2217,25288,16151,519238,0.0554864719791916,239228,823,0.06976093468445618,46184,701,64,0,765,63158,0.02585533850322584,-30033,47,637,15,0.15246195718489078,62,18991,0,5988,2458,-32,27437,13003,0.09806308064906054,366589,127361,
1031,0.1992288775274086,58,1128,-97,2217,25288,16151,519238,0.0554864719791916,239228,823,0.06976093468445618,46184,898,102,25,1025,63158,0.02585533850322584,-30033,22,796,271,0.08195242806615341,314,18991,21,5988,2458,249,27437,13003,0.09806308064906054,366589,127361,
1031,0.1992288775274086,58,1128,-97,2217,25288,16151,519238,0.0554864719791916,239228,823,0.06976093468445618,46184,898,102,25,1025,63158,0.02585533850322584,-30033,22,796,271,0.08195242806615341,314,18991,21,5988,2458,249,27437,13003,0.09806308064906054,366589,127361,
1031,0.1992288775274086,58,1128,-97,2217,25288,16151,519238,0.0554864719791916,239228,823,0.06976093468445618,46184,898,102,25,1025,63158,0.02585533850322584,-30033,22,796,271,0.08195242806615341,314,18991,21,5988,2458,249,27437,13003,0.09806308064906054,366589,127361,
1031,0.1992288775274086,58,1128,-97,2217,25288,16151,519238,0.0554864719791916,239228,823,0.06976093468445618,46184,898,102,25,1025,63158,0.02585533850322584,-30033,22,796,271,0.08195242806615341,314,18991,21,5988,2458,249,27437,13003,0.09806308064906054,366589,127361,
1031,0.1992288775274086,58,1128,-97,2217,25288,16151,519238,0.0554864719791916,239228,823,0.06976093468445618,46184,898,102,25,1025,63158,0.02585533850322584,-30033,22,796,271,0.08195242806615341,314,18991,21,5988,2458,249,27437,13003,0.09806308064906054,366589,127361,
1031,0.1992288775274086,58,1128,-97,2217,25288,16151,519238,0.0554864719791916,239228,823,0.06976093468445618,46184,898,102,25,1025,63158,0.02585533850322584,-30033,22,796,271,0.08195242806615341,314,18991,21,5988,2458,249,27437,13003,0.09806308064906054,366589,127361,
1031,0.1992288775274086,58,1128,-97,2217,25288,16151,519238,0.0554864719791916,239228,823,0.06976093468445618,46184,898,102,25,1025,63158,0.02585533850322584,-30033,22,796,271,0.08195242806615341,314,18991,21,5988,2458,249,27437,13003,0.09806308064906054,366589,127361,
1031,0.0,58,1128,-97,2217,25288,16151,519238,0.0554864719791916,239228,823,0.06976093468445618,46184,0,0,0,0,63158,0.02585533850322584,-30033,0,0,0,0.0,0,18991,0,5988,2458,0,27437,13003,0.09806308064906054,366589,127361,
1031,0.037037037037037035,58,1128,-97,2217,25288,16151,519238,0.0554864719791916,239228,823,0.06976093468445618,46184,206,26,4,236,63158,0.02585533850322584,-30033,0,180,4,0.06572035833232161,4,18991,0,5988,2458,4,27437,13003,0.09806308064906054,366589,127361,
1031,0.002398081534772182,58,1128,-97,2217,25288,16151,519238,0.0554864719791916,239228,823,0.06976093468445618,46184,85,13,2,100,63158,0.02585533850322584,-30033,0,72,1,0.042192570837706625,1,18991,0,5988,2458,1,27437,13003,0.09806308064906054,366589,127361,
1031,0.002398081534772182,58,1128,-97,2217,25288,16151,519238,0.0554864719791916,239228,823,0.06976093468445618,46184,85,13,2,100,63158,0.02585533850322584,-30033,0,72,1,0.042192570837706625,1,18991,0,5988,2458,1,27437,13003,0.09806308064906054,366589,127361,
1031,0.008156860224728729,58,1128,-97,2217,25288,16151,519238,0.0554864719791916,239228,823,0.06976093468445618,46184,205,43,35,283,63158,0.02585533850322584,-30033,2,162,3,0.07457089600247926,5,18991,0,5988,2458,1,27437,13003,0.09806308064906054,366589,127361,
1031,0.002331002331002331,58,1128,-97,2217,25288,16151,519238,0.0554864719791916,239228,823,0.06976093468445618,46184,62,12,2,76,63158,0.02585533850322584,-30033,0,50,1,0.01605503565904644,1,18991,0,5988,2458,1,27437,13003,0.09806308064906054,366589,127361,
1031,0.0021598272138228943,58,1128,-97,2217,25288,16151,519238,0.0554864719791916,239228,823,0.06976093468445618,46184,33,0,28,61,63158,0.02585533850322584,-30033,0,33,1,0.12453868825789004,1,18991,0,5988,2458,1,27437,13003,0.09806308064906054,366589,127361,
1031,0.02424830261881668,58,1128,-97,2217,25288,16151,519238,0.0554864719791916,239228,823,0.06976093468445618,46184,2,276,0,278,63158,0.02585533850322584,-30033,275,-274,0,0.012370943017206959,275,18991,0,5988,2458,-275,27437,13003,0.09806308064906054,366589,127361,
1031,0.02424830261881668,58,1128,-97,2217,25288,16151,519238,0.0554864719791916,239228,823,0.06976093468445618,46184,2,276,0,278,63158,0.02585533850322584,-30033,275,-274,0,0.012370943017206959,275,18991,0,5988,2458,-275,27437,13003,0.09806308064906054,366589,127361,
1031,0.02424830261881668,58,1128,-97,2217,25288,16151,519238,0.0554864719791916,239228,823,0.06976093468445618,46184,2,276,0,278,63158,0.02585533850322584,-30033,275,-274,0,0.012370943017206959,275,18991,0,5988,2458,-275,27437,13003,0.09806308064906054,366589,127361,
1031,0.02424830261881668,58,1128,-97,2217,25288,16151,519238,0.0554864719791916,239228,823,0.06976093468445618,46184,2,276,0,278,63158,0.02585533850322584,-30033,275,-274,0,0.012370943017206959,275,18991,0,5988,2458,-275,27437,13003,0.09806308064906054,366589,127361,
1031,0.028423665319529792,58,1128,-97,2217,25288,16151,519238,0.0554864719791916,239228,823,0.06976093468445618,46184,881,390,39,1310,63158,0.02585533850322584,-30033,2,491,15,0.10633965560367535,17,18991,0,5988,2458,13,27437,13003,0.09806308064906054,366589,127361,
1031,0.028423665319529792,58,1128,-97,2217,25288,16151,519238,0.0554864719791916,239228,823,0.06976093468445618,46184,881,390,39,1310,63158,0.02585533850322584,-30033,2,491,15,0.10633965560367535,17,18991,0,5988,2458,13,27437,13003,0.09806308064906054,366589,127361,
1031,0.3410084033613445,58,1128,-97,2217,25288,16151,519238,0.0554864719791916,239228,823,0.06976093468445618,46184,699,275,131,1105,63158,0.02585533850322584,-30033,2,424,65,0.17398707069544897,69,18991,2,5988,2458,63,27437,13003,0.09806308064906054,366589,127361,
1031,0.08980967486122125,58,1128,-97,2217,25288,16151,519238,0.0554864719791916,239228,823,0.06976093468445618,46184,140,39,10,189,63158,0.02585533850322584,-30033,0,101,80,0.039618956296610754,80,18991,0,5988,2458,80,27437,13003,0.09806308064906054,366589,127361,
1031,0.02986857825567503,58,1128,-97,2217,25288,16151,519238,0.0554864719791916,239228,823,0.06976093468445618,46184,1179,337,70,1586,63158,0.02585533850322584,-30033,0,842,25,0.1059027748861305,25,18991,0,5988,2458,25,27437,13003,0.09806308064906054,366589,127361,
1031,0.02986857825567503,58,1128,-97,2217,25288,16151,519238,0.0554864719791916,239228,823,0.06976093468445618,46184,1179,337,70,1586,63158,0.02585533850322584,-30033,0,842,25,0.1059027748861305,25,18991,0,5988,2458,25,27437,13003,0.09806308064906054,366589,127361,
1031,0.0,58,1128,-97,2217,25288,16151,519238,0.0554864719791916,239228,823,0.06976093468445618,46184,19,0,0,19,63158,0.02585533850322584,-30033,0,19,0,0.6333333333333333,0,18991,0,5988,2458,0,27437,13003,0.09806308064906054,366589,127361,
1031,0.013827672629850489,58,1128,-97,2217,25288,16151,519238,0.0554864719791916,239228,823,0.06976093468445618,46184,68,184,1,253,63158,0.02585533850322584,-30033,160,-116,0,0.19100887770430672,160,18991,0,5988,2458,-160,27437,13003,0.09806308064906054,366589,127361,
1031,0.008405501782985226,58,1128,-97,2217,25288,16151,519238,0.0554864719791916,239228,823,0.06976093468445618,46184,99,99,0,198,63158,0.02585533850322584,-30033,99,0,0,0.035413343577495135,99,18991,0,5988,2458,-99,27437,13003,0.09806308064906054,366589,127361,
1031,0.008405501782985226,58,1128,-97,2217,25288,16151,519238,0.0554864719791916,239228,823,0.06976093468445618,46184,99,99,0,198,63158,0.02585533850322584,-30033,99,0,0,0.035413343577495135,99,18991,0,5988,2458,-99,27437,13003,0.09806308064906054,366589,127361,
1031,0.008405501782985226,58,1128,-97,2217,25288,16151,519238,0.0554864719791916,239228,823,0.06976093468445618,46184,99,99,0,198,63158,0.02585533850322584,-30033,99,0,0,0.035413343577495135,99,18991,0,5988,2458,-99,27437,13003,0.09806308064906054,366589,127361,
30,0.0854449472096531,0,1436,-1406,1466,25288,16151,519238,0.024594148411393617,239228,823,0.06976093468445618,46184,117,1140,3,1260,63158,0.02585533850322584,-30033,1133,-1023,0,0.18211205908949796,1133,801,0,1562,12,-1133,2375,-761,0.0440556885212808,366589,127361,
30,0.0854449472096531,0,1436,-1406,1466,25288,16151,519238,0.024594148411393617,239228,823,0.06976093468445618,46184,117,1140,3,1260,63158,0.02585533850322584,-30033,1133,-1023,0,0.18211205908949796,1133,801,0,1562,12,-1133,2375,-761,0.0440556885212808,366589,127361,
30,0.0854449472096531,0,1436,-1406,1466,25288,16151,519238,0.024594148411393617,239228,823,0.06976093468445618,46184,117,1140,3,1260,63158,0.02585533850322584,-30033,1133,-1023,0,0.18211205908949796,1133,801,0,1562,12,-1133,2375,-761,0.0440556885212808,366589,127361,
30,0.0854449472096531,0,1436,-1406,1466,25288,16151,519238,0.024594148411393617,239228,823,0.06976093468445618,46184,117,1140,3,1260,63158,0.02585533850322584,-30033,1133,-1023,0,0.18211205908949796,1133,801,0,1562,12,-1133,2375,-761,0.0440556885212808,366589,127361,
30,0.0854449472096531,0,1436,-1406,1466,25288,16151,519238,0.024594148411393617,239228,823,0.06976093468445618,46184,117,1140,3,1260,63158,0.02585533850322584,-30033,1133,-1023,0,0.18211205908949796,1133,801,0,1562,12,-1133,2375,-761,0.0440556885212808,366589,127361,
30,0.0854449472096531,0,1436,-1406,1466,25288,16151,519238,0.024594148411393617,239228,823,0.06976093468445618,46184,117,1140,3,1260,63158,0.02585533850322584,-30033,1133,-1023,0,0.18211205908949796,1133,801,0,1562,12,-1133,2375,-761,0.0440556885212808,366589,127361,
30,0.04697986577181208,0,1436,-1406,1466,25288,16151,519238,0.024594148411393617,239228,823,0.06976093468445618,46184,349,25,0,374,63158,0.02585533850322584,-30033,16,324,12,0.08557184306221818,28,801,0,1562,12,-4,2375,-761,0.0440556885212808,366589,127361,
30,0.0,0,1436,-1406,1466,25288,16151,519238,0.024594148411393617,239228,823,0.06976093468445618,46184,21,2,0,23,63158,0.02585533850322584,-30033,0,19,0,0.010791830800975425,0,801,0,1562,12,0,2375,-761,0.0440556885212808,366589,127361,
30,0.01615759185480301,0,1436,-1406,1466,25288,16151,519238,0.024594148411393617,239228,823,0.06976093468445618,46184,27,236,3,266,63158,0.02585533850322584,-30033,219,-209,0,0.05647187926547963,219,801,0,1562,12,-219,2375,-761,0.0440556885212808,366589,127361,
30,0.01615759185480301,0,1436,-1406,1466,25288,16151,519238,0.024594148411393617,239228,823,0.06976093468445618,46184,27,236,3,266,63158,0.02585533850322584,-30033,219,-209,0,0.05647187926547963,219,801,0,1562,12,-219,2375,-761,0.0440556885212808,366589,127361,
0,0.0,0,0,0,0,25288,16151,519238,0.0,239228,823,0.06976093468445618,46184,177,0,0,177,63158,0.02585533850322584,-30033,0,177,0,0.04332925336597307,0,195,0,0,0,0,195,195,0.023850153637818977,366589,127361,
7,0.0018844221105527637,1,0,7,8,25288,16151,519238,0.005105615115893782,239228,823,0.06976093468445618,46184,266,106,43,415,63158,0.02585533850322584,-30033,0,160,2,0.07188876877022422,3,1710,1,417,339,2,2466,1293,0.015351099478265167,366589,127361,
326,0.08570487483530961,40,635,-309,1001,25288,16151,519238,0.02369831160571107,239228,823,0.06976093468445618,46184,852,101,8,961,63158,0.02585533850322584,-30033,5,751,5,0.20203102109068047,10,8117,0,3728,779,0,12624,4389,0.0764356303372631,366589,127361,
326,0.08570487483530961,40,635,-309,1001,25288,16151,519238,0.02369831160571107,239228,823,0.06976093468445618,46184,852,101,8,961,63158,0.02585533850322584,-30033,5,751,5,0.20203102109068047,10,8117,0,3728,779,0,12624,4389,0.0764356303372631,366589,127361,
326,0.08570487483530961,40,635,-309,1001,25288,16151,519238,0.02369831160571107,239228,823,0.06976093468445618,46184,852,101,8,961,63158,0.02585533850322584,-30033,5,751,5,0.20203102109068047,10,8117,0,3728,779,0,12624,4389,0.0764356303372631,366589,127361,
326,0.08570487483530961,40,635,-309,1001,25288,16151,519238,0.02369831160571107,239228,823,0.06976093468445618,46184,852,101,8,961,63158,0.02585533850322584,-30033,5,751,5,0.20203102109068047,10,8117,0,3728,779,0,12624,4389,0.0764356303372631,366589,127361,
326,0.08570487483530961,40,635,-309,1001,25288,16151,519238,0.02369831160571107,239228,823,0.06976093468445618,46184,852,101,8,961,63158,0.02585533850322584,-30033,5,751,5,0.20203102109068047,10,8117,0,3728,779,0,12624,4389,0.0764356303372631,366589,127361,
326,0.08570487483530961,40,635,-309,1001,25288,16151,519238,0.02369831160571107,239228,823,0.06976093468445618,46184,852,101,8,961,63158,0.02585533850322584,-30033,5,751,5,0.20203102109068047,10,8117,0,3728,779,0,12624,4389,0.0764356303372631,366589,127361,
326,0.08570487483530961,40,635,-309,1001,25288,16151,519238,0.02369831160571107,239228,823,0.06976093468445618,46184,852,101,8,961,63158,0.02585533850322584,-30033,5,751,5,0.20203102109068047,10,8117,0,3728,779,0,12624,4389,0.0764356303372631,366589,127361,
326,0.08570487483530961,40,635,-309,1001,25288,16151,519238,0.02369831160571107,239228,823,0.06976093468445618,46184,852,101,8,961,63158,0.02585533850322584,-30033,5,751,5,0.20203102109068047,10,8117,0,3728,779,0,12624,4389,0.0764356303372631,366589,127361,
326,0.09791880852482703,40,635,-309,1001,25288,16151,519238,0.02369831160571107,239228,823,0.06976093468445618,46184,466,65,2,533,63158,0.02585533850322584,-30033,10,401,6,0.08426420491265085,16,8117,0,3728,779,-4,12624,4389,0.0764356303372631,366589,127361,
326,0.09791880852482703,40,635,-309,1001,25288,16151,519238,0.02369831160571107,239228,823,0.06976093468445618,46184,466,65,2,533,63158,0.02585533850322584,-30033,10,401,6,0.08426420491265085,16,8117,0,3728,779,-4,12624,4389,0.0764356303372631,366589,127361,
326,0.09791880852482703,40,635,-309,1001,25288,16151,519238,0.02369831160571107,239228,823,0.06976093468445618,46184,466,65,2,533,63158,0.02585533850322584,-30033,10,401,6,0.08426420491265085,16,8117,0,3728,779,-4,12624,4389,0.0764356303372631,366589,127361,
326,0.09791880852482703,40,635,-309,1001,25288,16151,519238,0.02369831160571107,239228,823,0.06976093468445618,46184,466,65,2,533,63158,0.02585533850322584,-30033,10,401,6,0.08426420491265085,16,8117,0,3728,779,-4,12624,4389,0.0764356303372631,366589,127361,
326,0.0,40,635,-309,1001,25288,16151,519238,0.02369831160571107,239228,823,0.06976093468445618,46184,0,13,0,13,63158,0.02585533850322584,-30033,0,-13,0,0.2826086956521739,0,8117,0,3728,779,0,12624,4389,0.0764356303372631,366589,127361,
326,0.0,40,635,-309,1001,25288,16151,519238,0.02369831160571107,239228,823,0.06976093468445618,46184,0,13,0,13,63158,0.02585533850322584,-30033,0,-13,0,0.2826086956521739,0,8117,0,3728,779,0,12624,4389,0.0764356303372631,366589,127361,
326,0.0,40,635,-309,1001,25288,16151,519238,0.02369831160571107,239228,823,0.06976093468445618,46184,0,13,0,13,63158,0.02585533850322584,-30033,0,-13,0,0.2826086956521739,0,8117,0,3728,779,0,12624,4389,0.0764356303372631,366589,127361,
326,0.0,40,635,-309,1001,25288,16151,519238,0.02369831160571107,239228,823,0.06976093468445618,46184,0,13,0,13,63158,0.02585533850322584,-30033,0,-13,0,0.2826086956521739,0,8117,0,3728,779,0,12624,4389,0.0764356303372631,366589,127361,
326,0.0,40,635,-309,1001,25288,16151,519238,0.02369831160571107,239228,823,0.06976093468445618,46184,0,13,0,13,63158,0.02585533850322584,-30033,0,-13,0,0.2826086956521739,0,8117,0,3728,779,0,12624,4389,0.0764356303372631,366589,127361,
326,0.0,40,635,-309,1001,25288,16151,519238,0.02369831160571107,239228,823,0.06976093468445618,46184,0,13,0,13,63158,0.02585533850322584,-30033,0,-13,0,0.2826086956521739,0,8117,0,3728,779,0,12624,4389,0.0764356303372631,366589,127361,
326,0.0,40,635,-309,1001,25288,16151,519238,0.02369831160571107,239228,823,0.06976093468445618,46184,0,13,0,13,63158,0.02585533850322584,-30033,0,-13,0,0.2826086956521739,0,8117,0,3728,779,0,12624,4389,0.0764356303372631,366589,127361,
326,0.0,40,635,-309,1001,25288,16151,519238,0.02369831160571107,239228,823,0.06976093468445618,46184,124,0,0,124,63158,0.02585533850322584,-30033,0,124,0,0.6048780487804878,0,8117,0,3728,779,0,12624,4389,0.0764356303372631,366589,127361,
326,0.10457516339869281,40,635,-309,1001,25288,16151,519238,0.02369831160571107,239228,823,0.06976093468445618,46184,206,16,3,225,63158,0.02585533850322584,-30033,0,190,64,0.0935595595342694,64,8117,0,3728,779,64,12624,4389,0.0764356303372631,366589,127361,
326,0.045667534584194626,40,635,-309,1001,25288,16151,519238,0.02369831160571107,239228,823,0.06976093468445618,46184,363,85,32,480,63158,0.02585533850322584,-30033,11,278,97,0.05539229765932044,135,8117,27,3728,779,86,12624,4389,0.0764356303372631,366589,127361,
326,0.0,40,635,-309,1001,25288,16151,519238,0.02369831160571107,239228,823,0.06976093468445618,46184,3,0,2,5,63158,0.02585533850322584,-30033,0,3,0,1.7404622667780562E-4,0,8117,0,3728,779,0,12624,4389,0.0764356303372631,366589,127361,
326,0.5157593123209169,40,635,-309,1001,25288,16151,519238,0.02369831160571107,239228,823,0.06976093468445618,46184,535,222,452,1209,63158,0.02585533850322584,-30033,216,313,131,0.12324625461264632,360,8117,13,3728,779,-85,12624,4389,0.0764356303372631,366589,127361,
326,0.0,40,635,-309,1001,25288,16151,519238,0.02369831160571107,239228,823,0.06976093468445618,46184,356,160,9,525,63158,0.02585533850322584,-30033,0,196,0,0.07621983947721554,0,8117,0,3728,779,0,12624,4389,0.0764356303372631,366589,127361,
326,0.0,40,635,-309,1001,25288,16151,519238,0.02369831160571107,239228,823,0.06976093468445618,46184,356,160,9,525,63158,0.02585533850322584,-30033,0,196,0,0.07621983947721554,0,8117,0,3728,779,0,12624,4389,0.0764356303372631,366589,127361,
326,0.0,40,635,-309,1001,25288,16151,519238,0.02369831160571107,239228,823,0.06976093468445618,46184,356,160,9,525,63158,0.02585533850322584,-30033,0,196,0,0.07621983947721554,0,8117,0,3728,779,0,12624,4389,0.0764356303372631,366589,127361,
326,0.0,40,635,-309,1001,25288,16151,519238,0.02369831160571107,239228,823,0.06976093468445618,46184,356,160,9,525,63158,0.02585533850322584,-30033,0,196,0,0.07621983947721554,0,8117,0,3728,779,0,12624,4389,0.0764356303372631,366589,127361,
326,0.0,40,635,-309,1001,25288,16151,519238,0.02369831160571107,239228,823,0.06976093468445618,46184,356,160,9,525,63158,0.02585533850322584,-30033,0,196,0,0.07621983947721554,0,8117,0,3728,779,0,12624,4389,0.0764356303372631,366589,127361,
326,0.0,40,635,-309,1001,25288,16151,519238,0.02369831160571107,239228,823,0.06976093468445618,46184,356,160,9,525,63158,0.02585533850322584,-30033,0,196,0,0.07621983947721554,0,8117,0,3728,779,0,12624,4389,0.0764356303372631,366589,127361,
326,0.0,40,635,-309,1001,25288,16151,519238,0.02369831160571107,239228,823,0.06976093468445618,46184,356,160,9,525,63158,0.02585533850322584,-30033,0,196,0,0.07621983947721554,0,8117,0,3728,779,0,12624,4389,0.0764356303372631,366589,127361,
26,0.0,4,20,6,50,25288,16151,519238,0.017353322192426777,239228,823,0.06976093468445618,46184,34,0,0,34,63158,0.02585533850322584,-30033,0,34,0,0.12408759124087591,0,538,0,140,18,0,696,398,0.11447780055188785,366589,127361,
26,0.0,4,20,6,50,25288,16151,519238,0.017353322192426777,239228,823,0.06976093468445618,46184,84,5,0,89,63158,0.02585533850322584,-30033,0,79,0,0.201400882748033,0,538,0,140,18,0,696,398,0.11447780055188785,366589,127361,
36,0.04250793221860519,0,161,-125,197,25288,16151,519238,0.04250793221860519,239228,823,0.06976093468445618,46184,225,162,0,387,63158,0.02585533850322584,-30033,161,63,36,0.3130278294557525,197,225,0,162,0,-125,387,63,0.3130278294557525,366589,127361,
36,0.04250793221860519,0,161,-125,197,25288,16151,519238,0.04250793221860519,239228,823,0.06976093468445618,46184,225,162,0,387,63158,0.02585533850322584,-30033,161,63,36,0.3130278294557525,197,225,0,162,0,-125,387,63,0.3130278294557525,366589,127361,
36,0.04250793221860519,0,161,-125,197,25288,16151,519238,0.04250793221860519,239228,823,0.06976093468445618,46184,225,162,0,387,63158,0.02585533850322584,-30033,161,63,36,0.3130278294557525,197,225,0,162,0,-125,387,63,0.3130278294557525,366589,127361,
36,0.04250793221860519,0,161,-125,197,25288,16151,519238,0.04250793221860519,239228,823,0.06976093468445618,46184,225,162,0,387,63158,0.02585533850322584,-30033,161,63,36,0.3130278294557525,197,225,0,162,0,-125,387,63,0.3130278294557525,366589,127361,
36,0.04250793221860519,0,161,-125,197,25288,16151,519238,0.04250793221860519,239228,823,0.06976093468445618,46184,225,162,0,387,63158,0.02585533850322584,-30033,161,63,36,0.3130278294557525,197,225,0,162,0,-125,387,63,0.3130278294557525,366589,127361,
36,0.04250793221860519,0,161,-125,197,25288,16151,519238,0.04250793221860519,239228,823,0.06976093468445618,46184,225,162,0,387,63158,0.02585533850322584,-30033,161,63,36,0.3130278294557525,197,225,0,162,0,-125,387,63,0.3130278294557525,366589,127361,
36,0.04250793221860519,0,161,-125,197,25288,16151,519238,0.04250793221860519,239228,823,0.06976093468445618,46184,225,162,0,387,63158,0.02585533850322584,-30033,161,63,36,0.3130278294557525,197,225,0,162,0,-125,387,63,0.3130278294557525,366589,127361,
39,0.06543170071353788,0,21,18,60,25288,16151,519238,0.02606979033304184,239228,823,0.06976093468445618,46184,1239,261,124,1624,63158,0.02585533850322584,-30033,4,978,25,0.07516671214388944,29,2732,0,459,169,21,3360,2273,0.05667373458466979,366589,127361,
39,0.06543170071353788,0,21,18,60,25288,16151,519238,0.02606979033304184,239228,823,0.06976093468445618,46184,1239,261,124,1624,63158,0.02585533850322584,-30033,4,978,25,0.07516671214388944,29,2732,0,459,169,21,3360,2273,0.05667373458466979,366589,127361,
39,0.06543170071353788,0,21,18,60,25288,16151,519238,0.02606979033304184,239228,823,0.06976093468445618,46184,1239,261,124,1624,63158,0.02585533850322584,-30033,4,978,25,0.07516671214388944,29,2732,0,459,169,21,3360,2273,0.05667373458466979,366589,127361,
39,0.06543170071353788,0,21,18,60,25288,16151,519238,0.02606979033304184,239228,823,0.06976093468445618,46184,1239,261,124,1624,63158,0.02585533850322584,-30033,4,978,25,0.07516671214388944,29,2732,0,459,169,21,3360,2273,0.05667373458466979,366589,127361,
39,0.06543170071353788,0,21,18,60,25288,16151,519238,0.02606979033304184,239228,823,0.06976093468445618,46184,1239,261,124,1624,63158,0.02585533850322584,-30033,4,978,25,0.07516671214388944,29,2732,0,459,169,21,3360,2273,0.05667373458466979,366589,127361,
39,0.06543170071353788,0,21,18,60,25288,16151,519238,0.02606979033304184,239228,823,0.06976093468445618,46184,1239,261,124,1624,63158,0.02585533850322584,-30033,4,978,25,0.07516671214388944,29,2732,0,459,169,21,3360,2273,0.05667373458466979,366589,127361,
39,0.06543170071353788,0,21,18,60,25288,16151,519238,0.02606979033304184,239228,823,0.06976093468445618,46184,1239,261,124,1624,63158,0.02585533850322584,-30033,4,978,25,0.07516671214388944,29,2732,0,459,169,21,3360,2273,0.05667373458466979,366589,127361,
39,0.06543170071353788,0,21,18,60,25288,16151,519238,0.02606979033304184,239228,823,0.06976093468445618,46184,1239,261,124,1624,63158,0.02585533850322584,-30033,4,978,25,0.07516671214388944,29,2732,0,459,169,21,3360,2273,0.05667373458466979,366589,127361,
39,0.06543170071353788,0,21,18,60,25288,16151,519238,0.02606979033304184,239228,823,0.06976093468445618,46184,1239,261,124,1624,63158,0.02585533850322584,-30033,4,978,25,0.07516671214388944,29,2732,0,459,169,21,3360,2273,0.05667373458466979,366589,127361,
39,0.06543170071353788,0,21,18,60,25288,16151,519238,0.02606979033304184,239228,823,0.06976093468445618,46184,1239,261,124,1624,63158,0.02585533850322584,-30033,4,978,25,0.07516671214388944,29,2732,0,459,169,21,3360,2273,0.05667373458466979,366589,127361,
39,0.06543170071353788,0,21,18,60,25288,16151,519238,0.02606979033304184,239228,823,0.06976093468445618,46184,1239,261,124,1624,63158,0.02585533850322584,-30033,4,978,25,0.07516671214388944,29,2732,0,459,169,21,3360,2273,0.05667373458466979,366589,127361,
39,0.06543170071353788,0,21,18,60,25288,16151,519238,0.02606979033304184,239228,823,0.06976093468445618,46184,1239,261,124,1624,63158,0.02585533850322584,-30033,4,978,25,0.07516671214388944,29,2732,0,459,169,21,3360,2273,0.05667373458466979,366589,127361,
39,0.0,0,21,18,60,25288,16151,519238,0.02606979033304184,239228,823,0.06976093468445618,46184,232,6,0,238,63158,0.02585533850322584,-30033,0,226,0,0.09483776335305114,0,2732,0,459,169,0,3360,2273,0.05667373458466979,366589,127361,
39,0.0,0,21,18,60,25288,16151,519238,0.02606979033304184,239228,823,0.06976093468445618,46184,232,6,0,238,63158,0.02585533850322584,-30033,0,226,0,0.09483776335305114,0,2732,0,459,169,0,3360,2273,0.05667373458466979,366589,127361,
39,0.0,0,21,18,60,25288,16151,519238,0.02606979033304184,239228,823,0.06976093468445618,46184,232,6,0,238,63158,0.02585533850322584,-30033,0,226,0,0.09483776335305114,0,2732,0,459,169,0,3360,2273,0.05667373458466979,366589,127361,
7,0.016146393972012917,0,10,-3,17,25288,16151,519238,0.006742844525406419,239228,823,0.06976093468445618,46184,232,58,5,295,63158,0.02585533850322584,-30033,9,174,6,0.023838417455901838,15,979,0,143,52,-3,1174,836,0.061136996847073785,366589,127361,
7,0.0,0,10,-3,17,25288,16151,519238,0.006742844525406419,239228,823,0.06976093468445618,46184,80,19,5,104,63158,0.02585533850322584,-30033,0,61,0,0.011621217264510285,0,979,0,143,52,0,1174,836,0.061136996847073785,366589,127361,
71,0.034482758620689655,0,254,-183,325,25288,16151,519238,0.03515931230952766,239228,823,0.06976093468445618,46184,1,1,0,2,63158,0.02585533850322584,-30033,1,0,1,0.034482758620689655,2,71,0,254,0,0,325,-183,0.03515931230952766,366589,127361,
41,0.12613557516983204,0,389,-348,430,25288,16151,519238,0.12613557516983204,239228,823,0.06976093468445618,46184,263,483,33,779,63158,0.02585533850322584,-30033,389,-220,41,0.10951540409349993,430,263,0,483,33,-348,779,-220,0.10951540409349993,366589,127361,
41,0.12613557516983204,0,389,-348,430,25288,16151,519238,0.12613557516983204,239228,823,0.06976093468445618,46184,263,483,33,779,63158,0.02585533850322584,-30033,389,-220,41,0.10951540409349993,430,263,0,483,33,-348,779,-220,0.10951540409349993,366589,127361,
41,0.12613557516983204,0,389,-348,430,25288,16151,519238,0.12613557516983204,239228,823,0.06976093468445618,46184,263,483,33,779,63158,0.02585533850322584,-30033,389,-220,41,0.10951540409349993,430,263,0,483,33,-348,779,-220,0.10951540409349993,366589,127361,
16,0.0,0,21,-5,37,25288,16151,519238,0.0051941858342460755,239228,823,0.06976093468445618,46184,5,7,0,12,63158,0.02585533850322584,-30033,0,-2,0,0.001035424462956937,0,430,0,50,21,0,501,380,0.05336650717693807,366589,127361,
6,0.009341070578057718,0,4,2,10,25288,16151,519238,0.0041718912508869645,239228,823,0.06976093468445618,46184,410,33,17,460,63158,0.02585533850322584,-30033,1,377,5,0.06000895822084434,6,449,0,36,17,4,502,413,0.06879504256520179,366589,127361,
25,0.0,0,14,11,39,25288,16151,519238,0.02885650067152638,239228,823,0.06976093468445618,46184,231,108,3,342,63158,0.02585533850322584,-30033,0,123,0,0.27470113247772676,0,871,0,231,14,0,1116,640,0.05618352019977952,366589,127361,
25,0.0,0,14,11,39,25288,16151,519238,0.02885650067152638,239228,823,0.06976093468445618,46184,15,0,0,15,63158,0.02585533850322584,-30033,0,15,0,0.015772870662460567,0,871,0,231,14,0,1116,640,0.05618352019977952,366589,127361,
25,0.0,0,14,11,39,25288,16151,519238,0.02885650067152638,239228,823,0.06976093468445618,46184,15,0,0,15,63158,0.02585533850322584,-30033,0,15,0,0.015772870662460567,0,871,0,231,14,0,1116,640,0.05618352019977952,366589,127361,
3,0.012903225806451613,0,3,0,6,25288,16151,519238,0.010445468509984639,239228,823,0.06976093468445618,46184,2,2,0,4,63158,0.02585533850322584,-30033,2,0,2,0.012903225806451613,4,537,0,126,20,0,683,411,0.07094146786992742,366589,127361,
3,0.0,0,3,0,6,25288,16151,519238,0.010445468509984639,239228,823,0.06976093468445618,46184,67,23,8,98,63158,0.02585533850322584,-30033,0,44,0,0.4049586776859504,0,537,0,126,20,0,683,411,0.07094146786992742,366589,127361,
3,0.0,0,3,0,6,25288,16151,519238,0.010445468509984639,239228,823,0.06976093468445618,46184,67,23,8,98,63158,0.02585533850322584,-30033,0,44,0,0.4049586776859504,0,537,0,126,20,0,683,411,0.07094146786992742,366589,127361,
3,0.0,0,3,0,6,25288,16151,519238,0.010445468509984639,239228,823,0.06976093468445618,46184,67,23,8,98,63158,0.02585533850322584,-30033,0,44,0,0.4049586776859504,0,537,0,126,20,0,683,411,0.07094146786992742,366589,127361,
3,0.0,0,3,0,6,25288,16151,519238,0.010445468509984639,239228,823,0.06976093468445618,46184,67,23,8,98,63158,0.02585533850322584,-30033,0,44,0,0.4049586776859504,0,537,0,126,20,0,683,411,0.07094146786992742,366589,127361,
3,0.13333333333333333,0,3,0,6,25288,16151,519238,0.010445468509984639,239228,823,0.06976093468445618,46184,93,1,0,94,63158,0.02585533850322584,-30033,1,92,1,0.07295274354112674,2,537,0,126,20,0,683,411,0.07094146786992742,366589,127361,
3,0.0,0,3,0,6,25288,16151,519238,0.010445468509984639,239228,823,0.06976093468445618,46184,0,6,0,6,63158,0.02585533850322584,-30033,0,-6,0,0.00911854103343465,0,537,0,126,20,0,683,411,0.07094146786992742,366589,127361,
3,0.0,0,3,0,6,25288,16151,519238,0.010445468509984639,239228,823,0.06976093468445618,46184,0,6,0,6,63158,0.02585533850322584,-30033,0,-6,0,0.00911854103343465,0,537,0,126,20,0,683,411,0.07094146786992742,366589,127361,
3,0.0,0,3,0,6,25288,16151,519238,0.010445468509984639,239228,823,0.06976093468445618,46184,0,6,0,6,63158,0.02585533850322584,-30033,0,-6,0,0.00911854103343465,0,537,0,126,20,0,683,411,0.07094146786992742,366589,127361,
3,0.0,0,3,0,6,25288,16151,519238,0.010445468509984639,239228,823,0.06976093468445618,46184,34,0,0,34,63158,0.02585533850322584,-30033,0,34,0,0.028595458368376788,0,537,0,126,20,0,683,411,0.07094146786992742,366589,127361,
0,0.0,0,0,0,0,25288,16151,519238,0.0,239228,823,0.06976093468445618,46184,38,0,0,38,63158,0.02585533850322584,-30033,0,38,0,0.001329182552730071,0,1180,0,11,2,0,1193,1169,0.0051224761160756395,366589,127361,
3,0.0,0,3,0,6,25288,16151,519238,0.010445468509984639,239228,823,0.06976093468445618,46184,0,0,0,0,63158,0.02585533850322584,-30033,0,0,0,0.0,0,537,0,126,20,0,683,411,0.07094146786992742,366589,127361,
3,0.0,0,3,0,6,25288,16151,519238,0.010445468509984639,239228,823,0.06976093468445618,46184,0,0,0,0,63158,0.02585533850322584,-30033,0,0,0,0.0,0,537,0,126,20,0,683,411,0.07094146786992742,366589,127361,
3,0.0,0,3,0,6,25288,16151,519238,0.010445468509984639,239228,823,0.06976093468445618,46184,0,0,0,0,63158,0.02585533850322584,-30033,0,0,0,0.0,0,537,0,126,20,0,683,411,0.07094146786992742,366589,127361,
3,0.0,0,3,0,6,25288,16151,519238,0.010445468509984639,239228,823,0.06976093468445618,46184,0,0,0,0,63158,0.02585533850322584,-30033,0,0,0,0.0,0,537,0,126,20,0,683,411,0.07094146786992742,366589,127361,
0,0.0,0,0,0,0,25288,16151,519238,0.0,239228,823,0.06976093468445618,46184,189,39,7,235,63158,0.02585533850322584,-30033,0,150,0,0.030843768534833404,0,924,0,133,18,0,1075,791,0.05139526295567367,366589,127361,
0,0.0,0,0,0,0,25288,16151,519238,0.0,239228,823,0.06976093468445618,46184,1,1,0,2,63158,0.02585533850322584,-30033,0,0,0,0.024691358024691357,0,924,0,133,18,0,1075,791,0.05139526295567367,366589,127361,
0,0.0,0,0,0,0,25288,16151,519238,0.0,239228,823,0.06976093468445618,46184,1,1,0,2,63158,0.02585533850322584,-30033,0,0,0,0.024691358024691357,0,924,0,133,18,0,1075,791,0.05139526295567367,366589,127361,
0,0.0,0,0,0,0,25288,16151,519238,0.0,239228,823,0.06976093468445618,46184,10,8,0,18,63158,0.02585533850322584,-30033,0,2,0,0.015785520449699556,0,213,0,27,0,0,240,186,0.01845610142800562,366589,127361,
0,0.0,0,0,0,0,25288,16151,519238,0.0,239228,823,0.06976093468445618,46184,10,8,0,18,63158,0.02585533850322584,-30033,0,2,0,0.015785520449699556,0,213,0,27,0,0,240,186,0.01845610142800562,366589,127361,
0,0.0,0,0,0,0,25288,16151,519238,0.0,239228,823,0.06976093468445618,46184,10,8,0,18,63158,0.02585533850322584,-30033,0,2,0,0.015785520449699556,0,213,0,27,0,0,240,186,0.01845610142800562,366589,127361,
0,0.0,0,0,0,0,25288,16151,519238,0.0,239228,823,0.06976093468445618,46184,8,3,0,11,63158,0.02585533850322584,-30033,0,5,0,0.004684967733439138,0,213,0,27,0,0,240,186,0.01845610142800562,366589,127361,
0,0.0,0,0,0,0,25288,16151,519238,0.0,239228,823,0.06976093468445618,46184,8,3,0,11,63158,0.02585533850322584,-30033,0,5,0,0.004684967733439138,0,213,0,27,0,0,240,186,0.01845610142800562,366589,127361,
0,0.0,0,0,0,0,25288,16151,519238,0.0,239228,823,0.06976093468445618,46184,8,3,0,11,63158,0.02585533850322584,-30033,0,5,0,0.004684967733439138,0,213,0,27,0,0,240,186,0.01845610142800562,366589,127361,
0,0.0,0,0,0,0,25288,16151,519238,0.0,239228,823,0.06976093468445618,46184,126,8,0,134,63158,0.02585533850322584,-30033,0,118,0,0.038257726035831226,0,245,0,15,0,0,260,230,0.04125694914554296,366589,127361,
0,0.0,0,0,0,0,25288,16151,519238,0.0,239228,823,0.06976093468445618,46184,126,8,0,134,63158,0.02585533850322584,-30033,0,118,0,0.038257726035831226,0,245,0,15,0,0,260,230,0.04125694914554296,366589,127361,
0,0.0,0,0,0,0,25288,16151,519238,0.0,239228,823,0.06976093468445618,46184,126,8,0,134,63158,0.02585533850322584,-30033,0,118,0,0.038257726035831226,0,245,0,15,0,0,260,230,0.04125694914554296,366589,127361,
0,0.0,0,0,0,0,25288,16151,519238,0.0,239228,823,0.06976093468445618,46184,1,3,0,4,63158,0.02585533850322584,-30033,0,-2,0,0.007575757575757576,0,245,0,15,0,0,260,230,0.04125694914554296,366589,127361,
0,0.0,0,0,0,0,25288,16151,519238,0.0,239228,823,0.06976093468445618,46184,1,3,0,4,63158,0.02585533850322584,-30033,0,-2,0,0.007575757575757576,0,245,0,15,0,0,260,230,0.04125694914554296,366589,127361,
0,0.0,0,0,0,0,25288,16151,519238,0.0,239228,823,0.06976093468445618,46184,61,1,0,62,63158,0.02585533850322584,-30033,0,60,0,0.13898355851126257,0,61,0,1,1,0,63,60,0.06949386503976097,366589,127361,
0,0.0,0,0,0,0,25288,16151,519238,0.0,239228,823,0.06976093468445618,46184,61,1,0,62,63158,0.02585533850322584,-30033,0,60,0,0.13898355851126257,0,61,0,1,1,0,63,60,0.06949386503976097,366589,127361,
0,0.0,0,0,0,0,25288,16151,519238,0.0,239228,823,0.06976093468445618,46184,61,1,0,62,63158,0.02585533850322584,-30033,0,60,0,0.13898355851126257,0,61,0,1,1,0,63,60,0.06949386503976097,366589,127361,
0,0.0,0,0,0,0,25288,16151,519238,0.0,239228,823,0.06976093468445618,46184,61,1,0,62,63158,0.02585533850322584,-30033,0,60,0,0.13898355851126257,0,61,0,1,1,0,63,60,0.06949386503976097,366589,127361,
0,0.0,0,0,0,0,25288,16151,519238,0.0,239228,823,0.06976093468445618,46184,0,0,1,1,63158,0.02585533850322584,-30033,0,0,0,4.171568259371428E-6,0,61,0,1,1,0,63,60,0.06949386503976097,366589,127361,
0,0.0,0,0,0,0,25288,16151,519238,0.0,239228,823,0.06976093468445618,46184,0,0,1,1,63158,0.02585533850322584,-30033,0,0,0,4.171568259371428E-6,0,61,0,1,1,0,63,60,0.06949386503976097,366589,127361,
0,0.0,0,0,0,0,25288,16151,519238,0.0,239228,823,0.06976093468445618,46184,0,0,1,1,63158,0.02585533850322584,-30033,0,0,0,4.171568259371428E-6,0,61,0,1,1,0,63,60,0.06949386503976097,366589,127361,
0,0.0,0,0,0,0,25288,16151,519238,0.0,239228,823,0.06976093468445618,46184,0,0,1,1,63158,0.02585533850322584,-30033,0,0,0,4.171568259371428E-6,0,61,0,1,1,0,63,60,0.06949386503976097,366589,127361,
1,0.0,0,1,0,2,25288,16151,519238,1.77210703526493E-4,239228,823,0.06976093468445618,46184,5,1,0,6,63158,0.02585533850322584,-30033,0,4,0,0.11989424983476536,0,784,0,54,25,0,863,730,0.03970451575975195,366589,127361,
1,0.0,0,1,0,2,25288,16151,519238,1.77210703526493E-4,239228,823,0.06976093468445618,46184,22,4,0,26,63158,0.02585533850322584,-30033,0,18,0,5.860157006123602E-4,0,784,0,54,25,0,863,730,0.03970451575975195,366589,127361,
1,0.0,0,1,0,2,25288,16151,519238,1.77210703526493E-4,239228,823,0.06976093468445618,46184,22,4,0,26,63158,0.02585533850322584,-30033,0,18,0,5.860157006123602E-4,0,784,0,54,25,0,863,730,0.03970451575975195,366589,127361,
1,0.0,0,1,0,2,25288,16151,519238,1.77210703526493E-4,239228,823,0.06976093468445618,46184,22,4,0,26,63158,0.02585533850322584,-30033,0,18,0,5.860157006123602E-4,0,784,0,54,25,0,863,730,0.03970451575975195,366589,127361,
1,0.0,0,1,0,2,25288,16151,519238,1.77210703526493E-4,239228,823,0.06976093468445618,46184,5,1,0,6,63158,0.02585533850322584,-30033,0,4,0,0.2727272727272727,0,784,0,54,25,0,863,730,0.03970451575975195,366589,127361,
1,0.0,0,1,0,2,25288,16151,519238,1.77210703526493E-4,239228,823,0.06976093468445618,46184,74,0,0,74,63158,0.02585533850322584,-30033,0,74,0,0.0011715534165030713,0,784,0,54,25,0,863,730,0.03970451575975195,366589,127361,
1,0.0,0,1,0,2,25288,16151,519238,1.77210703526493E-4,239228,823,0.06976093468445618,46184,74,0,0,74,63158,0.02585533850322584,-30033,0,74,0,0.0011715534165030713,0,784,0,54,25,0,863,730,0.03970451575975195,366589,127361,
1,0.0,0,1,0,2,25288,16151,519238,1.77210703526493E-4,239228,823,0.06976093468445618,46184,130,0,0,130,63158,0.02585533850322584,-30033,0,130,0,0.0020458909068018,0,784,0,54,25,0,863,730,0.03970451575975195,366589,127361,
1,0.0,0,1,0,2,25288,16151,519238,1.77210703526493E-4,239228,823,0.06976093468445618,46184,23,8,0,31,63158,0.02585533850322584,-30033,0,15,0,0.06425796154552484,0,784,0,54,25,0,863,730,0.03970451575975195,366589,127361,
1,0.0,0,1,0,2,25288,16151,519238,1.77210703526493E-4,239228,823,0.06976093468445618,46184,23,8,0,31,63158,0.02585533850322584,-30033,0,15,0,0.06425796154552484,0,784,0,54,25,0,863,730,0.03970451575975195,366589,127361,
1,0.0,0,1,0,2,25288,16151,519238,1.77210703526493E-4,239228,823,0.06976093468445618,46184,23,8,0,31,63158,0.02585533850322584,-30033,0,15,0,0.06425796154552484,0,784,0,54,25,0,863,730,0.03970451575975195,366589,127361,
6,0.0,0,6,0,12,25288,16151,519238,0.0022091310751104565,239228,823,0.06976093468445618,46184,101,0,0,101,63158,0.02585533850322584,-30033,0,101,0,0.00411271276162554,0,771,0,6,0,0,777,765,0.0038391170933832846,366589,127361,
6,0.0,0,6,0,12,25288,16151,519238,0.0022091310751104565,239228,823,0.06976093468445618,46184,101,0,0,101,63158,0.02585533850322584,-30033,0,101,0,0.00411271276162554,0,771,0,6,0,0,777,765,0.0038391170933832846,366589,127361,
6,0.0,0,6,0,12,25288,16151,519238,0.0022091310751104565,239228,823,0.06976093468445618,46184,101,0,0,101,63158,0.02585533850322584,-30033,0,101,0,0.00411271276162554,0,771,0,6,0,0,777,765,0.0038391170933832846,366589,127361,
6,0.0,0,6,0,12,25288,16151,519238,0.0022091310751104565,239228,823,0.06976093468445618,46184,69,0,0,69,63158,0.02585533850322584,-30033,0,69,0,0.001065340909090909,0,771,0,6,0,0,777,765,0.0038391170933832846,366589,127361,
6,0.0,0,6,0,12,25288,16151,519238,0.0022091310751104565,239228,823,0.06976093468445618,46184,69,0,0,69,63158,0.02585533850322584,-30033,0,69,0,0.001065340909090909,0,771,0,6,0,0,777,765,0.0038391170933832846,366589,127361,
6,0.0,0,6,0,12,25288,16151,519238,0.0022091310751104565,239228,823,0.06976093468445618,46184,69,0,0,69,63158,0.02585533850322584,-30033,0,69,0,0.001065340909090909,0,771,0,6,0,0,777,765,0.0038391170933832846,366589,127361,
6,0.0,0,6,0,12,25288,16151,519238,0.0022091310751104565,239228,823,0.06976093468445618,46184,69,0,0,69,63158,0.02585533850322584,-30033,0,69,0,0.001065340909090909,0,771,0,6,0,0,777,765,0.0038391170933832846,366589,127361,
6,0.0,0,6,0,12,25288,16151,519238,0.0022091310751104565,239228,823,0.06976093468445618,46184,69,0,0,69,63158,0.02585533850322584,-30033,0,69,0,0.001065340909090909,0,771,0,6,0,0,777,765,0.0038391170933832846,366589,127361,
6,0.0,0,6,0,12,25288,16151,519238,0.0022091310751104565,239228,823,0.06976093468445618,46184,69,0,0,69,63158,0.02585533850322584,-30033,0,69,0,0.001065340909090909,0,771,0,6,0,0,777,765,0.0038391170933832846,366589,127361,
6,0.0,0,6,0,12,25288,16151,519238,0.0022091310751104565,239228,823,0.06976093468445618,46184,69,0,0,69,63158,0.02585533850322584,-30033,0,69,0,0.001065340909090909,0,771,0,6,0,0,777,765,0.0038391170933832846,366589,127361,
6,0.0,0,6,0,12,25288,16151,519238,0.0022091310751104565,239228,823,0.06976093468445618,46184,69,0,0,69,63158,0.02585533850322584,-30033,0,69,0,0.001065340909090909,0,771,0,6,0,0,777,765,0.0038391170933832846,366589,127361,
6,0.0,0,6,0,12,25288,16151,519238,0.0022091310751104565,239228,823,0.06976093468445618,46184,69,0,0,69,63158,0.02585533850322584,-30033,0,69,0,0.001065340909090909,0,771,0,6,0,0,777,765,0.0038391170933832846,366589,127361,
6,0.030927835051546393,0,6,0,12,25288,16151,519238,0.0022091310751104565,239228,823,0.06976093468445618,46184,6,6,0,12,63158,0.02585533850322584,-30033,6,0,6,0.030927835051546393,12,771,0,6,0,0,777,765,0.0038391170933832846,366589,127361,
6,0.030927835051546393,0,6,0,12,25288,16151,519238,0.0022091310751104565,239228,823,0.06976093468445618,46184,6,6,0,12,63158,0.02585533850322584,-30033,6,0,6,0.030927835051546393,12,771,0,6,0,0,777,765,0.0038391170933832846,366589,127361,
6,0.0,0,6,0,12,25288,16151,519238,0.0022091310751104565,239228,823,0.06976093468445618,46184,59,0,0,59,63158,0.02585533850322584,-30033,0,59,0,9.087268582694144E-4,0,771,0,6,0,0,777,765,0.0038391170933832846,366589,127361,
6,0.0,0,6,0,12,25288,16151,519238,0.0022091310751104565,239228,823,0.06976093468445618,46184,60,0,0,60,63158,0.02585533850322584,-30033,0,60,0,9.218005838070364E-4,0,771,0,6,0,0,777,765,0.0038391170933832846,366589,127361,
6,0.0,0,6,0,12,25288,16151,519238,0.0022091310751104565,239228,823,0.06976093468445618,46184,112,0,0,112,63158,0.02585533850322584,-30033,0,112,0,0.004477134633834346,0,771,0,6,0,0,777,765,0.0038391170933832846,366589,127361,
6,0.0,0,6,0,12,25288,16151,519238,0.0022091310751104565,239228,823,0.06976093468445618,46184,112,0,0,112,63158,0.02585533850322584,-30033,0,112,0,0.004477134633834346,0,771,0,6,0,0,777,765,0.0038391170933832846,366589,127361,
6,0.0,0,6,0,12,25288,16151,519238,0.0022091310751104565,239228,823,0.06976093468445618,46184,112,0,0,112,63158,0.02585533850322584,-30033,0,112,0,0.004477134633834346,0,771,0,6,0,0,777,765,0.0038391170933832846,366589,127361,
6,0.0,0,6,0,12,25288,16151,519238,0.0022091310751104565,239228,823,0.06976093468445618,46184,134,0,0,134,63158,0.02585533850322584,-30033,0,134,0,0.002048679060665362,0,771,0,6,0,0,777,765,0.0038391170933832846,366589,127361,
6,0.0,0,6,0,12,25288,16151,519238,0.0022091310751104565,239228,823,0.06976093468445618,46184,65,0,0,65,63158,0.02585533850322584,-30033,0,65,0,0.002589538265407753,0,771,0,6,0,0,777,765,0.0038391170933832846,366589,127361,
6,0.0,0,6,0,12,25288,16151,519238,0.0022091310751104565,239228,823,0.06976093468445618,46184,0,0,0,0,63158,0.02585533850322584,-30033,0,0,0,0.0,0,771,0,6,0,0,777,765,0.0038391170933832846,366589,127361,
0,0.0,0,0,0,0,25288,16151,519238,0.0,239228,823,0.06976093468445618,46184,0,0,0,0,63158,0.02585533850322584,-30033,0,0,0,0.0,0,226,0,0,0,0,226,226,0.05548855541814154,366589,127361,
0,0.0,0,0,0,0,25288,16151,519238,0.0,239228,823,0.06976093468445618,46184,90,0,0,90,63158,0.02585533850322584,-30033,0,90,0,0.05813953488372093,0,226,0,0,0,0,226,226,0.05548855541814154,366589,127361,
1,0.0,0,1,0,2,25288,16151,519238,2.457606291472106E-4,239228,823,0.06976093468445618,46184,174,5,0,179,63158,0.02585533850322584,-30033,0,169,0,0.03775971007471422,0,847,0,14,19,0,880,833,0.030498184204878605,366589,127361,
1,0.0,0,1,0,2,25288,16151,519238,2.457606291472106E-4,239228,823,0.06976093468445618,46184,174,5,0,179,63158,0.02585533850322584,-30033,0,169,0,0.03775971007471422,0,847,0,14,19,0,880,833,0.030498184204878605,366589,127361,
1,0.0,0,1,0,2,25288,16151,519238,2.457606291472106E-4,239228,823,0.06976093468445618,46184,174,5,0,179,63158,0.02585533850322584,-30033,0,169,0,0.03775971007471422,0,847,0,14,19,0,880,833,0.030498184204878605,366589,127361,
1,0.003194888178913738,0,1,0,2,25288,16151,519238,2.457606291472106E-4,239228,823,0.06976093468445618,46184,33,6,0,39,63158,0.02585533850322584,-30033,1,27,1,0.1379214031054139,2,847,0,14,19,0,880,833,0.030498184204878605,366589,127361,
1,0.003194888178913738,0,1,0,2,25288,16151,519238,2.457606291472106E-4,239228,823,0.06976093468445618,46184,33,6,0,39,63158,0.02585533850322584,-30033,1,27,1,0.1379214031054139,2,847,0,14,19,0,880,833,0.030498184204878605,366589,127361,
1,0.003194888178913738,0,1,0,2,25288,16151,519238,2.457606291472106E-4,239228,823,0.06976093468445618,46184,33,6,0,39,63158,0.02585533850322584,-30033,1,27,1,0.1379214031054139,2,847,0,14,19,0,880,833,0.030498184204878605,366589,127361,
0,0.0,0,0,0,0,25288,16151,519238,0.0,239228,823,0.06976093468445618,46184,49,2,1,52,63158,0.02585533850322584,-30033,0,47,0,0.021015927452801373,0,965,0,36,4,0,1005,929,0.018487002168646682,366589,127361,
0,0.0,0,0,0,0,25288,16151,519238,0.0,239228,823,0.06976093468445618,46184,119,2,0,121,63158,0.02585533850322584,-30033,0,117,0,0.04076378488498586,0,965,0,36,4,0,1005,929,0.018487002168646682,366589,127361,
0,0.0,0,0,0,0,25288,16151,519238,0.0,239228,823,0.06976093468445618,46184,62,0,0,62,63158,0.02585533850322584,-30033,0,62,0,0.0023320544647558866,0,965,0,36,4,0,1005,929,0.018487002168646682,366589,127361,
0,0.0,0,0,0,0,25288,16151,519238,0.0,239228,823,0.06976093468445618,46184,19,2,1,22,63158,0.02585533850322584,-30033,0,17,0,0.039927404718693285,0,965,0,36,4,0,1005,929,0.018487002168646682,366589,127361,
0,0.0,0,0,0,0,25288,16151,519238,0.0,239228,823,0.06976093468445618,46184,19,2,1,22,63158,0.02585533850322584,-30033,0,17,0,0.039927404718693285,0,965,0,36,4,0,1005,929,0.018487002168646682,366589,127361,
0,0.0,0,0,0,0,25288,16151,519238,0.0,239228,823,0.06976093468445618,46184,61,3,0,64,63158,0.02585533850322584,-30033,0,58,0,0.0397399108329115,0,965,0,36,4,0,1005,929,0.018487002168646682,366589,127361,
0,0.0,0,0,0,0,25288,16151,519238,0.0,239228,823,0.06976093468445618,46184,61,3,0,64,63158,0.02585533850322584,-30033,0,58,0,0.0397399108329115,0,965,0,36,4,0,1005,929,0.018487002168646682,366589,127361,
0,0.0,0,0,0,0,25288,16151,519238,0.0,239228,823,0.06976093468445618,46184,33,1,0,34,63158,0.02585533850322584,-30033,0,32,0,0.24788851351351351,0,965,0,36,4,0,1005,929,0.018487002168646682,366589,127361,
0,0.0,0,0,0,0,25288,16151,519238,0.0,239228,823,0.06976093468445618,46184,75,8,0,83,63158,0.02585533850322584,-30033,0,67,0,0.013486922266795447,0,965,0,36,4,0,1005,929,0.018487002168646682,366589,127361,
0,0.0,0,0,0,0,25288,16151,519238,0.0,239228,823,0.06976093468445618,46184,4,2,0,6,63158,0.02585533850322584,-30033,0,2,0,0.08108108108108109,0,98,0,2,0,0,100,96,0.0642062001578618,366589,127361,
0,0.0,0,0,0,0,25288,16151,519238,0.0,239228,823,0.06976093468445618,46184,94,0,0,94,63158,0.02585533850322584,-30033,0,94,0,0.0473313192346425,0,98,0,2,0,0,100,96,0.0642062001578618,366589,127361,
0,0.0,0,0,0,0,25288,16151,519238,0.0,239228,823,0.06976093468445618,46184,94,0,0,94,63158,0.02585533850322584,-30033,0,94,0,0.0473313192346425,0,98,0,2,0,0,100,96,0.0642062001578618,366589,127361,
0,0.0,0,0,0,0,25288,16151,519238,0.0,239228,823,0.06976093468445618,46184,94,0,0,94,63158,0.02585533850322584,-30033,0,94,0,0.0473313192346425,0,98,0,2,0,0,100,96,0.0642062001578618,366589,127361,
0,0.0,0,0,0,0,25288,16151,519238,0.0,239228,823,0.06976093468445618,46184,94,0,0,94,63158,0.02585533850322584,-30033,0,94,0,0.0473313192346425,0,98,0,2,0,0,100,96,0.0642062001578618,366589,127361,
0,0.0,0,0,0,0,25288,16151,519238,0.0,239228,823,0.06976093468445618,46184,94,0,0,94,63158,0.02585533850322584,-30033,0,94,0,0.0473313192346425,0,98,0,2,0,0,100,96,0.0642062001578618,366589,127361,
1,0.0,0,1,0,2,25288,16151,519238,4.3554006968641115E-4,239228,823,0.06976093468445618,46184,61,41,16,118,63158,0.02585533850322584,-30033,0,20,0,0.08031848141844161,0,515,0,63,21,0,599,452,0.06706766187281346,366589,127361,
1,0.0,0,1,0,2,25288,16151,519238,4.3554006968641115E-4,239228,823,0.06976093468445618,46184,61,41,16,118,63158,0.02585533850322584,-30033,0,20,0,0.08031848141844161,0,515,0,63,21,0,599,452,0.06706766187281346,366589,127361,
1,0.0,0,1,0,2,25288,16151,519238,4.3554006968641115E-4,239228,823,0.06976093468445618,46184,61,41,16,118,63158,0.02585533850322584,-30033,0,20,0,0.08031848141844161,0,515,0,63,21,0,599,452,0.06706766187281346,366589,127361,
1,0.0,0,1,0,2,25288,16151,519238,4.3554006968641115E-4,239228,823,0.06976093468445618,46184,149,15,5,169,63158,0.02585533850322584,-30033,0,134,0,0.14357050611793765,0,515,0,63,21,0,599,452,0.06706766187281346,366589,127361,
0,0.0,0,0,0,0,25288,16151,519238,0.0,239228,823,0.06976093468445618,46184,0,0,0,0,63158,0.02585533850322584,-30033,0,0,0,0.0,0,1180,0,11,2,0,1193,1169,0.0051224761160756395,366589,127361,
0,0.0,0,0,0,0,25288,16151,519238,0.0,239228,823,0.06976093468445618,46184,0,0,0,0,63158,0.02585533850322584,-30033,0,0,0,0.0,0,1180,0,11,2,0,1193,1169,0.0051224761160756395,366589,127361,
0,0.0,0,0,0,0,25288,16151,519238,0.0,239228,823,0.06976093468445618,46184,0,0,0,0,63158,0.02585533850322584,-30033,0,0,0,0.0,0,1180,0,11,2,0,1193,1169,0.0051224761160756395,366589,127361,
0,0.0,0,0,0,0,25288,16151,519238,0.0,239228,823,0.06976093468445618,46184,0,0,0,0,63158,0.02585533850322584,-30033,0,0,0,0.0,0,1180,0,11,2,0,1193,1169,0.0051224761160756395,366589,127361,
0,0.0,0,0,0,0,25288,16151,519238,0.0,239228,823,0.06976093468445618,46184,0,0,0,0,63158,0.02585533850322584,-30033,0,0,0,0.0,0,1180,0,11,2,0,1193,1169,0.0051224761160756395,366589,127361,
0,0.0,0,0,0,0,25288,16151,519238,0.0,239228,823,0.06976093468445618,46184,84,0,0,84,63158,0.02585533850322584,-30033,0,84,0,0.10218978102189781,0,287,0,0,0,0,287,287,0.06253223593283606,366589,127361,
0,0.0,0,0,0,0,25288,16151,519238,0.0,239228,823,0.06976093468445618,46184,50,0,0,50,63158,0.02585533850322584,-30033,0,50,0,0.04159733777038269,0,287,0,0,0,0,287,287,0.06253223593283606,366589,127361,
0,0.0,0,0,0,0,25288,16151,519238,0.0,239228,823,0.06976093468445618,46184,0,0,0,0,63158,0.02585533850322584,-30033,0,0,0,0.0,0,644,0,28,10,0,682,616,0.010601980685242393,366589,127361,
0,0.0,0,0,0,0,25288,16151,519238,0.0,239228,823,0.06976093468445618,46184,129,8,3,140,63158,0.02585533850322584,-30033,0,121,0,0.01377201510953801,0,644,0,28,10,0,682,616,0.010601980685242393,366589,127361,
0,0.0,0,0,0,0,25288,16151,519238,0.0,239228,823,0.06976093468445618,46184,129,8,3,140,63158,0.02585533850322584,-30033,0,121,0,0.01377201510953801,0,644,0,28,10,0,682,616,0.010601980685242393,366589,127361,
0,0.0,0,0,0,0,25288,16151,519238,0.0,239228,823,0.06976093468445618,46184,129,8,3,140,63158,0.02585533850322584,-30033,0,121,0,0.01377201510953801,0,644,0,28,10,0,682,616,0.010601980685242393,366589,127361,
0,0.0,0,0,0,0,25288,16151,519238,0.0,239228,823,0.06976093468445618,46184,2,1,0,3,63158,0.02585533850322584,-30033,0,1,0,0.002142857142857143,0,100,0,1,0,0,101,99,0.025085229186303775,366589,127361,
0,0.0,0,0,0,0,25288,16151,519238,0.0,239228,823,0.06976093468445618,46184,2,1,0,3,63158,0.02585533850322584,-30033,0,1,0,0.002142857142857143,0,100,0,1,0,0,101,99,0.025085229186303775,366589,127361,
0,0.0,0,0,0,0,25288,16151,519238,0.0,239228,823,0.06976093468445618,46184,2,1,0,3,63158,0.02585533850322584,-30033,0,1,0,0.002142857142857143,0,100,0,1,0,0,101,99,0.025085229186303775,366589,127361,
0,0.0,0,0,0,0,25288,16151,519238,0.0,239228,823,0.06976093468445618,46184,2,1,0,3,63158,0.02585533850322584,-30033,0,1,0,0.002142857142857143,0,100,0,1,0,0,101,99,0.025085229186303775,366589,127361,
0,0.0,0,0,0,0,25288,16151,519238,0.0,239228,823,0.06976093468445618,46184,36,0,0,36,63158,0.02585533850322584,-30033,0,36,0,0.0011714555335003742,0,100,0,1,0,0,101,99,0.025085229186303775,366589,127361,
8,0.04155844155844156,0,8,0,16,25288,16151,519238,0.04155844155844156,239228,823,0.06976093468445618,46184,235,8,0,243,63158,0.02585533850322584,-30033,8,227,8,0.019858149199577794,16,235,0,8,0,0,243,227,0.019858149199577794,366589,127361,
8,0.04155844155844156,0,8,0,16,25288,16151,519238,0.04155844155844156,239228,823,0.06976093468445618,46184,235,8,0,243,63158,0.02585533850322584,-30033,8,227,8,0.019858149199577794,16,235,0,8,0,0,243,227,0.019858149199577794,366589,127361,
8,0.04155844155844156,0,8,0,16,25288,16151,519238,0.04155844155844156,239228,823,0.06976093468445618,46184,235,8,0,243,63158,0.02585533850322584,-30033,8,227,8,0.019858149199577794,16,235,0,8,0,0,243,227,0.019858149199577794,366589,127361,
8,0.04155844155844156,0,8,0,16,25288,16151,519238,0.04155844155844156,239228,823,0.06976093468445618,46184,235,8,0,243,63158,0.02585533850322584,-30033,8,227,8,0.019858149199577794,16,235,0,8,0,0,243,227,0.019858149199577794,366589,127361,
8,0.04155844155844156,0,8,0,16,25288,16151,519238,0.04155844155844156,239228,823,0.06976093468445618,46184,235,8,0,243,63158,0.02585533850322584,-30033,8,227,8,0.019858149199577794,16,235,0,8,0,0,243,227,0.019858149199577794,366589,127361,
3,0.0,0,2,1,5,25288,16151,519238,0.0021853146853146855,239228,823,0.06976093468445618,46184,63,1,0,64,63158,0.02585533850322584,-30033,0,62,0,0.23867917499690425,0,253,0,19,0,0,272,234,0.14861882395224316,366589,127361,
3,0.017482517482517484,0,2,1,5,25288,16151,519238,0.0021853146853146855,239228,823,0.06976093468445618,46184,3,2,0,5,63158,0.02585533850322584,-30033,2,1,3,0.017482517482517484,5,253,0,19,0,1,272,234,0.14861882395224316,366589,127361,
3,0.017482517482517484,0,2,1,5,25288,16151,519238,0.0021853146853146855,239228,823,0.06976093468445618,46184,3,2,0,5,63158,0.02585533850322584,-30033,2,1,3,0.017482517482517484,5,253,0,19,0,1,272,234,0.14861882395224316,366589,127361,
3,0.0,0,2,1,5,25288,16151,519238,0.0021853146853146855,239228,823,0.06976093468445618,46184,18,15,0,33,63158,0.02585533850322584,-30033,0,3,0,0.0677318394553348,0,253,0,19,0,0,272,234,0.14861882395224316,366589,127361,
3,0.0,0,2,1,5,25288,16151,519238,0.0021853146853146855,239228,823,0.06976093468445618,46184,18,15,0,33,63158,0.02585533850322584,-30033,0,3,0,0.0677318394553348,0,253,0,19,0,0,272,234,0.14861882395224316,366589,127361,
3,0.0,0,2,1,5,25288,16151,519238,0.0021853146853146855,239228,823,0.06976093468445618,46184,18,15,0,33,63158,0.02585533850322584,-30033,0,3,0,0.0677318394553348,0,253,0,19,0,0,272,234,0.14861882395224316,366589,127361,
3,0.0,0,2,1,5,25288,16151,519238,0.0021853146853146855,239228,823,0.06976093468445618,46184,18,15,0,33,63158,0.02585533850322584,-30033,0,3,0,0.0677318394553348,0,253,0,19,0,0,272,234,0.14861882395224316,366589,127361,
3,0.0,0,2,1,5,25288,16151,519238,0.0021853146853146855,239228,823,0.06976093468445618,46184,18,15,0,33,63158,0.02585533850322584,-30033,0,3,0,0.0677318394553348,0,253,0,19,0,0,272,234,0.14861882395224316,366589,127361,
9,0.09876543209876543,0,7,2,16,25288,16151,519238,0.03292181069958847,239228,823,0.06976093468445618,46184,220,196,15,431,63158,0.02585533850322584,-30033,7,24,9,0.48169192913262826,16,321,0,201,16,2,538,120,0.29698097373204013,366589,127361,
9,0.09876543209876543,0,7,2,16,25288,16151,519238,0.03292181069958847,239228,823,0.06976093468445618,46184,220,196,15,431,63158,0.02585533850322584,-30033,7,24,9,0.48169192913262826,16,321,0,201,16,2,538,120,0.29698097373204013,366589,127361,
9,0.09876543209876543,0,7,2,16,25288,16151,519238,0.03292181069958847,239228,823,0.06976093468445618,46184,220,196,15,431,63158,0.02585533850322584,-30033,7,24,9,0.48169192913262826,16,321,0,201,16,2,538,120,0.29698097373204013,366589,127361,
9,0.09876543209876543,0,7,2,16,25288,16151,519238,0.03292181069958847,239228,823,0.06976093468445618,46184,220,196,15,431,63158,0.02585533850322584,-30033,7,24,9,0.48169192913262826,16,321,0,201,16,2,538,120,0.29698097373204013,366589,127361,
19,0.0797872340425532,0,38,-19,57,25288,16151,519238,0.02578781593414961,239228,823,0.06976093468445618,46184,14,521,0,535,63158,0.02585533850322584,-30033,11,-507,4,0.05472237328033555,15,385,0,1674,7,-7,2066,-1289,0.022447435533939523,366589,127361,
19,0.0797872340425532,0,38,-19,57,25288,16151,519238,0.02578781593414961,239228,823,0.06976093468445618,46184,14,521,0,535,63158,0.02585533850322584,-30033,11,-507,4,0.05472237328033555,15,385,0,1674,7,-7,2066,-1289,0.022447435533939523,366589,127361,
19,0.0967741935483871,0,38,-19,57,25288,16151,519238,0.02578781593414961,239228,823,0.06976093468445618,46184,171,171,0,342,63158,0.02585533850322584,-30033,12,0,12,0.05219536963430199,24,385,0,1674,7,0,2066,-1289,0.022447435533939523,366589,127361,
19,0.0967741935483871,0,38,-19,57,25288,16151,519238,0.02578781593414961,239228,823,0.06976093468445618,46184,171,171,0,342,63158,0.02585533850322584,-30033,12,0,12,0.05219536963430199,24,385,0,1674,7,0,2066,-1289,0.022447435533939523,366589,127361,
19,0.017391304347826087,0,38,-19,57,25288,16151,519238,0.02578781593414961,239228,823,0.06976093468445618,46184,4,86,0,90,63158,0.02585533850322584,-30033,4,-82,0,0.017310126377153734,4,385,0,1674,7,-4,2066,-1289,0.022447435533939523,366589,127361,
19,0.0,0,38,-19,57,25288,16151,519238,0.02578781593414961,239228,823,0.06976093468445618,46184,13,274,0,287,63158,0.02585533850322584,-30033,0,-261,0,0.02124764794719632,0,385,0,1674,7,0,2066,-1289,0.022447435533939523,366589,127361,
0,0.0,0,0,0,0,25288,16151,519238,0.0,239228,823,0.06976093468445618,46184,185,0,0,185,63158,0.02585533850322584,-30033,0,185,0,0.049215216812982174,0,2998,0,0,0,0,2998,2998,0.077222758791422,366589,127361,
0,0.0,0,0,0,0,25288,16151,519238,0.0,239228,823,0.06976093468445618,46184,185,0,0,185,63158,0.02585533850322584,-30033,0,185,0,0.049215216812982174,0,2998,0,0,0,0,2998,2998,0.077222758791422,366589,127361,
0,0.0,0,0,0,0,25288,16151,519238,0.0,239228,823,0.06976093468445618,46184,185,0,0,185,63158,0.02585533850322584,-30033,0,185,0,0.049215216812982174,0,2998,0,0,0,0,2998,2998,0.077222758791422,366589,127361,
0,0.0,0,0,0,0,25288,16151,519238,0.0,239228,823,0.06976093468445618,46184,1100,0,0,1100,63158,0.02585533850322584,-30033,0,1100,0,0.220485067147725,0,2998,0,0,0,0,2998,2998,0.077222758791422,366589,127361,
0,0.0,0,0,0,0,25288,16151,519238,0.0,239228,823,0.06976093468445618,46184,1100,0,0,1100,63158,0.02585533850322584,-30033,0,1100,0,0.220485067147725,0,2998,0,0,0,0,2998,2998,0.077222758791422,366589,127361,
0,0.0,0,0,0,0,25288,16151,519238,0.0,239228,823,0.06976093468445618,46184,1100,0,0,1100,63158,0.02585533850322584,-30033,0,1100,0,0.220485067147725,0,2998,0,0,0,0,2998,2998,0.077222758791422,366589,127361,
0,0.0,0,0,0,0,25288,16151,519238,0.0,239228,823,0.06976093468445618,46184,1100,0,0,1100,63158,0.02585533850322584,-30033,0,1100,0,0.220485067147725,0,2998,0,0,0,0,2998,2998,0.077222758791422,366589,127361,
0,0.0,0,0,0,0,25288,16151,519238,0.0,239228,823,0.06976093468445618,46184,1100,0,0,1100,63158,0.02585533850322584,-30033,0,1100,0,0.220485067147725,0,2998,0,0,0,0,2998,2998,0.077222758791422,366589,127361,
0,0.0,0,0,0,0,25288,16151,519238,0.0,239228,823,0.06976093468445618,46184,112,0,0,112,63158,0.02585533850322584,-30033,0,112,0,0.021875,0,2998,0,0,0,0,2998,2998,0.077222758791422,366589,127361,
0,0.0,0,0,0,0,25288,16151,519238,0.0,239228,823,0.06976093468445618,46184,925,0,0,925,63158,0.02585533850322584,-30033,0,925,0,0.14938630490956073,0,2998,0,0,0,0,2998,2998,0.077222758791422,366589,127361,
0,0.0,0,0,0,0,25288,16151,519238,0.0,239228,823,0.06976093468445618,46184,925,0,0,925,63158,0.02585533850322584,-30033,0,925,0,0.14938630490956073,0,2998,0,0,0,0,2998,2998,0.077222758791422,366589,127361,
0,0.0,0,0,0,0,25288,16151,519238,0.0,239228,823,0.06976093468445618,46184,925,0,0,925,63158,0.02585533850322584,-30033,0,925,0,0.14938630490956073,0,2998,0,0,0,0,2998,2998,0.077222758791422,366589,127361,
0,0.0,0,0,0,0,25288,16151,519238,0.0,239228,823,0.06976093468445618,46184,925,0,0,925,63158,0.02585533850322584,-30033,0,925,0,0.14938630490956073,0,2998,0,0,0,0,2998,2998,0.077222758791422,366589,127361,
0,0.0,0,0,0,0,25288,16151,519238,0.0,239228,823,0.06976093468445618,46184,925,0,0,925,63158,0.02585533850322584,-30033,0,925,0,0.14938630490956073,0,2998,0,0,0,0,2998,2998,0.077222758791422,366589,127361,
0,0.0,0,0,0,0,25288,16151,519238,0.0,239228,823,0.06976093468445618,46184,925,0,0,925,63158,0.02585533850322584,-30033,0,925,0,0.14938630490956073,0,2998,0,0,0,0,2998,2998,0.077222758791422,366589,127361,
0,0.0,0,0,0,0,25288,16151,519238,0.0,239228,823,0.06976093468445618,46184,925,0,0,925,63158,0.02585533850322584,-30033,0,925,0,0.14938630490956073,0,2998,0,0,0,0,2998,2998,0.077222758791422,366589,127361,
0,0.0,0,0,0,0,25288,16151,519238,0.0,239228,823,0.06976093468445618,46184,925,0,0,925,63158,0.02585533850322584,-30033,0,925,0,0.14938630490956073,0,2998,0,0,0,0,2998,2998,0.077222758791422,366589,127361,
0,0.0,0,0,0,0,25288,16151,519238,0.0,239228,823,0.06976093468445618,46184,925,0,0,925,63158,0.02585533850322584,-30033,0,925,0,0.14938630490956073,0,2998,0,0,0,0,2998,2998,0.077222758791422,366589,127361,
0,0.0,0,0,0,0,25288,16151,519238,0.0,239228,823,0.06976093468445618,46184,925,0,0,925,63158,0.02585533850322584,-30033,0,925,0,0.14938630490956073,0,2998,0,0,0,0,2998,2998,0.077222758791422,366589,127361,
0,0.0,0,0,0,0,25288,16151,519238,0.0,239228,823,0.06976093468445618,46184,925,0,0,925,63158,0.02585533850322584,-30033,0,925,0,0.14938630490956073,0,2998,0,0,0,0,2998,2998,0.077222758791422,366589,127361,
0,0.0,0,0,0,0,25288,16151,519238,0.0,239228,823,0.06976093468445618,46184,925,0,0,925,63158,0.02585533850322584,-30033,0,925,0,0.14938630490956073,0,2998,0,0,0,0,2998,2998,0.077222758791422,366589,127361,
0,0.0,0,0,0,0,25288,16151,519238,0.0,239228,823,0.06976093468445618,46184,406,0,0,406,63158,0.02585533850322584,-30033,0,406,0,0.06068759342301943,0,2998,0,0,0,0,2998,2998,0.077222758791422,366589,127361,
0,0.0,0,0,0,0,25288,16151,519238,0.0,239228,823,0.06976093468445618,46184,406,0,0,406,63158,0.02585533850322584,-30033,0,406,0,0.06068759342301943,0,2998,0,0,0,0,2998,2998,0.077222758791422,366589,127361,
0,0.0,0,0,0,0,25288,16151,519238,0.0,239228,823,0.06976093468445618,46184,406,0,0,406,63158,0.02585533850322584,-30033,0,406,0,0.06068759342301943,0,2998,0,0,0,0,2998,2998,0.077222758791422,366589,127361,
0,0.0,0,0,0,0,25288,16151,519238,0.0,239228,823,0.06976093468445618,46184,406,0,0,406,63158,0.02585533850322584,-30033,0,406,0,0.06068759342301943,0,2998,0,0,0,0,2998,2998,0.077222758791422,366589,127361,
0,0.0,0,0,0,0,25288,16151,519238,0.0,239228,823,0.06976093468445618,46184,406,0,0,406,63158,0.02585533850322584,-30033,0,406,0,0.06068759342301943,0,2998,0,0,0,0,2998,2998,0.077222758791422,366589,127361,
0,0.0,0,0,0,0,25288,16151,519238,0.0,239228,823,0.06976093468445618,46184,406,0,0,406,63158,0.02585533850322584,-30033,0,406,0,0.06068759342301943,0,2998,0,0,0,0,2998,2998,0.077222758791422,366589,127361,
0,0.0,0,0,0,0,25288,16151,519238,0.0,239228,823,0.06976093468445618,46184,406,0,0,406,63158,0.02585533850322584,-30033,0,406,0,0.06068759342301943,0,2998,0,0,0,0,2998,2998,0.077222758791422,366589,127361,
0,0.0,0,0,0,0,25288,16151,519238,0.0,239228,823,0.06976093468445618,46184,406,0,0,406,63158,0.02585533850322584,-30033,0,406,0,0.06068759342301943,0,2998,0,0,0,0,2998,2998,0.077222758791422,366589,127361,
0,0.0,0,0,0,0,25288,16151,519238,0.0,239228,823,0.06976093468445618,46184,406,0,0,406,63158,0.02585533850322584,-30033,0,406,0,0.06068759342301943,0,2998,0,0,0,0,2998,2998,0.077222758791422,366589,127361,
0,0.0,0,0,0,0,25288,16151,519238,0.0,239228,823,0.06976093468445618,46184,406,0,0,406,63158,0.02585533850322584,-30033,0,406,0,0.06068759342301943,0,2998,0,0,0,0,2998,2998,0.077222758791422,366589,127361,
0,0.0,0,0,0,0,25288,16151,519238,0.0,239228,823,0.06976093468445618,46184,406,0,0,406,63158,0.02585533850322584,-30033,0,406,0,0.06068759342301943,0,2998,0,0,0,0,2998,2998,0.077222758791422,366589,127361,
0,0.0,0,0,0,0,25288,16151,519238,0.0,239228,823,0.06976093468445618,46184,406,0,0,406,63158,0.02585533850322584,-30033,0,406,0,0.06068759342301943,0,2998,0,0,0,0,2998,2998,0.077222758791422,366589,127361,
0,0.0,0,0,0,0,25288,16151,519238,0.0,239228,823,0.06976093468445618,46184,406,0,0,406,63158,0.02585533850322584,-30033,0,406,0,0.06068759342301943,0,2998,0,0,0,0,2998,2998,0.077222758791422,366589,127361,
0,0.0,0,0,0,0,25288,16151,519238,0.0,239228,823,0.06976093468445618,46184,406,0,0,406,63158,0.02585533850322584,-30033,0,406,0,0.06068759342301943,0,2998,0,0,0,0,2998,2998,0.077222758791422,366589,127361,
0,0.0,0,0,0,0,25288,16151,519238,0.0,239228,823,0.06976093468445618,46184,406,0,0,406,63158,0.02585533850322584,-30033,0,406,0,0.06068759342301943,0,2998,0,0,0,0,2998,2998,0.077222758791422,366589,127361,
0,0.0,0,0,0,0,25288,16151,519238,0.0,239228,823,0.06976093468445618,46184,406,0,0,406,63158,0.02585533850322584,-30033,0,406,0,0.06068759342301943,0,2998,0,0,0,0,2998,2998,0.077222758791422,366589,127361,
0,0.0,0,0,0,0,25288,16151,519238,0.0,239228,823,0.06976093468445618,46184,406,0,0,406,63158,0.02585533850322584,-30033,0,406,0,0.06068759342301943,0,2998,0,0,0,0,2998,2998,0.077222758791422,366589,127361,
0,0.0,0,0,0,0,25288,16151,519238,0.0,239228,823,0.06976093468445618,46184,406,0,0,406,63158,0.02585533850322584,-30033,0,406,0,0.06068759342301943,0,2998,0,0,0,0,2998,2998,0.077222758791422,366589,127361,
0,0.0,0,0,0,0,25288,16151,519238,0.0,239228,823,0.06976093468445618,46184,406,0,0,406,63158,0.02585533850322584,-30033,0,406,0,0.06068759342301943,0,2998,0,0,0,0,2998,2998,0.077222758791422,366589,127361,
0,0.0,0,0,0,0,25288,16151,519238,0.0,239228,823,0.06976093468445618,46184,406,0,0,406,63158,0.02585533850322584,-30033,0,406,0,0.06068759342301943,0,2998,0,0,0,0,2998,2998,0.077222758791422,366589,127361,
0,0.0,0,0,0,0,25288,16151,519238,0.0,239228,823,0.06976093468445618,46184,143,0,0,143,63158,0.02585533850322584,-30033,0,143,0,0.020364568499003134,0,2998,0,0,0,0,2998,2998,0.077222758791422,366589,127361,
195,0.02185792349726776,1,82,113,278,25288,16151,519238,0.005273026108751942,239228,823,0.06976093468445618,46184,135,55,7,197,63158,0.02585533850322584,-30033,2,80,2,0.014491923876932008,4,13631,0,1971,535,0,16137,11660,0.016901896838155607,366589,127361,
195,0.0,1,82,113,278,25288,16151,519238,0.005273026108751942,239228,823,0.06976093468445618,46184,113,59,4,176,63158,0.02585533850322584,-30033,0,54,0,0.0074345689565581165,0,13631,0,1971,535,0,16137,11660,0.016901896838155607,366589,127361,
195,0.004098360655737705,1,82,113,278,25288,16151,519238,0.005273026108751942,239228,823,0.06976093468445618,46184,240,96,30,366,63158,0.02585533850322584,-30033,1,144,1,0.07148801811529813,2,13631,0,1971,535,0,16137,11660,0.016901896838155607,366589,127361,
195,0.004098360655737705,1,82,113,278,25288,16151,519238,0.005273026108751942,239228,823,0.06976093468445618,46184,240,96,30,366,63158,0.02585533850322584,-30033,1,144,1,0.07148801811529813,2,13631,0,1971,535,0,16137,11660,0.016901896838155607,366589,127361,
195,0.02029520295202952,1,82,113,278,25288,16151,519238,0.005273026108751942,239228,823,0.06976093468445618,46184,800,126,3,929,63158,0.02585533850322584,-30033,10,674,1,0.12224761612949307,11,13631,0,1971,535,-9,16137,11660,0.016901896838155607,366589,127361,
195,0.02029520295202952,1,82,113,278,25288,16151,519238,0.005273026108751942,239228,823,0.06976093468445618,46184,800,126,3,929,63158,0.02585533850322584,-30033,10,674,1,0.12224761612949307,11,13631,0,1971,535,-9,16137,11660,0.016901896838155607,366589,127361,
195,0.02029520295202952,1,82,113,278,25288,16151,519238,0.005273026108751942,239228,823,0.06976093468445618,46184,800,126,3,929,63158,0.02585533850322584,-30033,10,674,1,0.12224761612949307,11,13631,0,1971,535,-9,16137,11660,0.016901896838155607,366589,127361,
195,0.02029520295202952,1,82,113,278,25288,16151,519238,0.005273026108751942,239228,823,0.06976093468445618,46184,800,126,3,929,63158,0.02585533850322584,-30033,10,674,1,0.12224761612949307,11,13631,0,1971,535,-9,16137,11660,0.016901896838155607,366589,127361,
195,0.02029520295202952,1,82,113,278,25288,16151,519238,0.005273026108751942,239228,823,0.06976093468445618,46184,800,126,3,929,63158,0.02585533850322584,-30033,10,674,1,0.12224761612949307,11,13631,0,1971,535,-9,16137,11660,0.016901896838155607,366589,127361,
195,0.02029520295202952,1,82,113,278,25288,16151,519238,0.005273026108751942,239228,823,0.06976093468445618,46184,800,126,3,929,63158,0.02585533850322584,-30033,10,674,1,0.12224761612949307,11,13631,0,1971,535,-9,16137,11660,0.016901896838155607,366589,127361,
195,0.02029520295202952,1,82,113,278,25288,16151,519238,0.005273026108751942,239228,823,0.06976093468445618,46184,800,126,3,929,63158,0.02585533850322584,-30033,10,674,1,0.12224761612949307,11,13631,0,1971,535,-9,16137,11660,0.016901896838155607,366589,127361,
195,0.0,1,82,113,278,25288,16151,519238,0.005273026108751942,239228,823,0.06976093468445618,46184,9,1,36,46,63158,0.02585533850322584,-30033,0,8,0,0.00787173050778988,0,13631,0,1971,535,0,16137,11660,0.016901896838155607,366589,127361,
195,0.0577319587628866,1,82,113,278,25288,16151,519238,0.005273026108751942,239228,823,0.06976093468445618,46184,1713,491,143,2347,63158,0.02585533850322584,-30033,14,1222,14,0.08441075025075218,28,13631,0,1971,535,0,16137,11660,0.016901896838155607,366589,127361,
195,0.0,1,82,113,278,25288,16151,519238,0.005273026108751942,239228,823,0.06976093468445618,46184,156,0,0,156,63158,0.02585533850322584,-30033,0,156,0,0.06149296806116992,0,13631,0,1971,535,0,16137,11660,0.016901896838155607,366589,127361,
195,0.0,1,82,113,278,25288,16151,519238,0.005273026108751942,239228,823,0.06976093468445618,46184,173,27,0,200,63158,0.02585533850322584,-30033,0,146,0,6.460640123714658E-4,0,13631,0,1971,535,0,16137,11660,0.016901896838155607,366589,127361,
195,0.0,1,82,113,278,25288,16151,519238,0.005273026108751942,239228,823,0.06976093468445618,46184,173,27,0,200,63158,0.02585533850322584,-30033,0,146,0,6.460640123714658E-4,0,13631,0,1971,535,0,16137,11660,0.016901896838155607,366589,127361,
195,0.0,1,82,113,278,25288,16151,519238,0.005273026108751942,239228,823,0.06976093468445618,46184,173,27,0,200,63158,0.02585533850322584,-30033,0,146,0,6.460640123714658E-4,0,13631,0,1971,535,0,16137,11660,0.016901896838155607,366589,127361,
195,0.0,1,82,113,278,25288,16151,519238,0.005273026108751942,239228,823,0.06976093468445618,46184,175,28,4,207,63158,0.02585533850322584,-30033,0,147,0,0.050914735126956136,0,13631,0,1971,535,0,16137,11660,0.016901896838155607,366589,127361,
195,0.0,1,82,113,278,25288,16151,519238,0.005273026108751942,239228,823,0.06976093468445618,46184,175,28,4,207,63158,0.02585533850322584,-30033,0,147,0,0.050914735126956136,0,13631,0,1971,535,0,16137,11660,0.016901896838155607,366589,127361,
195,0.0,1,82,113,278,25288,16151,519238,0.005273026108751942,239228,823,0.06976093468445618,46184,175,28,4,207,63158,0.02585533850322584,-30033,0,147,0,0.050914735126956136,0,13631,0,1971,535,0,16137,11660,0.016901896838155607,366589,127361,
195,0.01892744479495268,1,82,113,278,25288,16151,519238,0.005273026108751942,239228,823,0.06976093468445618,46184,1305,108,53,1466,63158,0.02585533850322584,-30033,3,1197,3,0.07296509693636034,6,13631,0,1971,535,0,16137,11660,0.016901896838155607,366589,127361,
195,0.01892744479495268,1,82,113,278,25288,16151,519238,0.005273026108751942,239228,823,0.06976093468445618,46184,1305,108,53,1466,63158,0.02585533850322584,-30033,3,1197,3,0.07296509693636034,6,13631,0,1971,535,0,16137,11660,0.016901896838155607,366589,127361,
195,0.01892744479495268,1,82,113,278,25288,16151,519238,0.005273026108751942,239228,823,0.06976093468445618,46184,1305,108,53,1466,63158,0.02585533850322584,-30033,3,1197,3,0.07296509693636034,6,13631,0,1971,535,0,16137,11660,0.016901896838155607,366589,127361,
195,0.049159840538921015,1,82,113,278,25288,16151,519238,0.005273026108751942,239228,823,0.06976093468445618,46184,1363,460,51,1874,63158,0.02585533850322584,-30033,3,903,40,0.07042322999132973,44,13631,1,1971,535,37,16137,11660,0.016901896838155607,366589,127361,
195,0.049159840538921015,1,82,113,278,25288,16151,519238,0.005273026108751942,239228,823,0.06976093468445618,46184,1363,460,51,1874,63158,0.02585533850322584,-30033,3,903,40,0.07042322999132973,44,13631,1,1971,535,37,16137,11660,0.016901896838155607,366589,127361,
195,0.049159840538921015,1,82,113,278,25288,16151,519238,0.005273026108751942,239228,823,0.06976093468445618,46184,1363,460,51,1874,63158,0.02585533850322584,-30033,3,903,40,0.07042322999132973,44,13631,1,1971,535,37,16137,11660,0.016901896838155607,366589,127361,
195,0.0,1,82,113,278,25288,16151,519238,0.005273026108751942,239228,823,0.06976093468445618,46184,83,20,2,105,63158,0.02585533850322584,-30033,0,63,0,0.002829497674473924,0,13631,0,1971,535,0,16137,11660,0.016901896838155607,366589,127361,
195,0.0,1,82,113,278,25288,16151,519238,0.005273026108751942,239228,823,0.06976093468445618,46184,83,20,2,105,63158,0.02585533850322584,-30033,0,63,0,0.002829497674473924,0,13631,0,1971,535,0,16137,11660,0.016901896838155607,366589,127361,
195,0.0029154518950437317,1,82,113,278,25288,16151,519238,0.005273026108751942,239228,823,0.06976093468445618,46184,416,85,9,510,63158,0.02585533850322584,-30033,0,331,1,0.031086525950812738,1,13631,0,1971,535,1,16137,11660,0.016901896838155607,366589,127361,
195,0.0029154518950437317,1,82,113,278,25288,16151,519238,0.005273026108751942,239228,823,0.06976093468445618,46184,416,85,9,510,63158,0.02585533850322584,-30033,0,331,1,0.031086525950812738,1,13631,0,1971,535,1,16137,11660,0.016901896838155607,366589,127361,
195,0.0029154518950437317,1,82,113,278,25288,16151,519238,0.005273026108751942,239228,823,0.06976093468445618,46184,416,85,9,510,63158,0.02585533850322584,-30033,0,331,1,0.031086525950812738,1,13631,0,1971,535,1,16137,11660,0.016901896838155607,366589,127361,
195,0.0029154518950437317,1,82,113,278,25288,16151,519238,0.005273026108751942,239228,823,0.06976093468445618,46184,416,85,9,510,63158,0.02585533850322584,-30033,0,331,1,0.031086525950812738,1,13631,0,1971,535,1,16137,11660,0.016901896838155607,366589,127361,
195,0.0,1,82,113,278,25288,16151,519238,0.005273026108751942,239228,823,0.06976093468445618,46184,121,0,0,121,63158,0.02585533850322584,-30033,0,121,0,0.010685270222536207,0,13631,0,1971,535,0,16137,11660,0.016901896838155607,366589,127361,
0,0.0,0,0,0,0,25288,16151,519238,0.0,239228,823,0.06976093468445618,46184,146,0,0,146,63158,0.02585533850322584,-30033,0,146,0,0.011146739960299282,0,12231,0,181,126,0,12538,12050,0.005861597848422336,366589,127361,
0,0.0,0,0,0,0,25288,16151,519238,0.0,239228,823,0.06976093468445618,46184,80,0,0,80,63158,0.02585533850322584,-30033,0,80,0,0.006053726825576996,0,12231,0,181,126,0,12538,12050,0.005861597848422336,366589,127361,
0,0.0,0,0,0,0,25288,16151,519238,0.0,239228,823,0.06976093468445618,46184,97,0,0,97,63158,0.02585533850322584,-30033,0,97,0,0.00726646190725897,0,12231,0,181,126,0,12538,12050,0.005861597848422336,366589,127361,
0,0.0,0,0,0,0,25288,16151,519238,0.0,239228,823,0.06976093468445618,46184,98,0,0,98,63158,0.02585533850322584,-30033,0,98,0,0.007267873034707802,0,12231,0,181,126,0,12538,12050,0.005861597848422336,366589,127361,
0,0.0,0,0,0,0,25288,16151,519238,0.0,239228,823,0.06976093468445618,46184,81,0,0,81,63158,0.02585533850322584,-30033,0,81,0,0.005955006616674019,0,12231,0,181,126,0,12538,12050,0.005861597848422336,366589,127361,
0,0.0,0,0,0,0,25288,16151,519238,0.0,239228,823,0.06976093468445618,46184,172,0,0,172,63158,0.02585533850322584,-30033,0,172,0,0.012450235251538183,0,12231,0,181,126,0,12538,12050,0.005861597848422336,366589,127361,
0,0.0,0,0,0,0,25288,16151,519238,0.0,239228,823,0.06976093468445618,46184,81,0,0,81,63158,0.02585533850322584,-30033,0,81,0,0.005813536209000215,0,12231,0,181,126,0,12538,12050,0.005861597848422336,366589,127361,
0,0.0,0,0,0,0,25288,16151,519238,0.0,239228,823,0.06976093468445618,46184,136,0,0,136,63158,0.02585533850322584,-30033,0,136,0,0.009640603955483093,0,12231,0,181,126,0,12538,12050,0.005861597848422336,366589,127361,
0,0.0,0,0,0,0,25288,16151,519238,0.0,239228,823,0.06976093468445618,46184,110,0,0,110,63158,0.02585533850322584,-30033,0,110,0,0.007717132033113512,0,12231,0,181,126,0,12538,12050,0.005861597848422336,366589,127361,
0,0.0,0,0,0,0,25288,16151,519238,0.0,239228,823,0.06976093468445618,46184,81,0,0,81,63158,0.02585533850322584,-30033,0,81,0,0.005635958808794879,0,12231,0,181,126,0,12538,12050,0.005861597848422336,366589,127361,
0,0.0,0,0,0,0,25288,16151,519238,0.0,239228,823,0.06976093468445618,46184,135,0,0,135,63158,0.02585533850322584,-30033,0,135,0,0.009281540048126504,0,12231,0,181,126,0,12538,12050,0.005861597848422336,366589,127361,
0,0.0,0,0,0,0,25288,16151,519238,0.0,239228,823,0.06976093468445618,46184,135,0,0,135,63158,0.02585533850322584,-30033,0,135,0,0.009172441907867916,0,12231,0,181,126,0,12538,12050,0.005861597848422336,366589,127361,
0,0.0,0,0,0,0,25288,16151,519238,0.0,239228,823,0.06976093468445618,46184,109,0,0,109,63158,0.02585533850322584,-30033,0,109,0,0.0073331539289558665,0,12231,0,181,126,0,12538,12050,0.005861597848422336,366589,127361,
0,0.0,0,0,0,0,25288,16151,519238,0.0,239228,823,0.06976093468445618,46184,69,0,0,69,63158,0.02585533850322584,-30033,0,69,0,0.004609218436873747,0,12231,0,181,126,0,12538,12050,0.005861597848422336,366589,127361,
0,0.0,0,0,0,0,25288,16151,519238,0.0,239228,823,0.06976093468445618,46184,85,0,0,85,63158,0.02585533850322584,-30033,0,85,0,0.005632122979061754,0,12231,0,181,126,0,12538,12050,0.005861597848422336,366589,127361,
0,0.0,0,0,0,0,25288,16151,519238,0.0,239228,823,0.06976093468445618,46184,85,0,0,85,63158,0.02585533850322584,-30033,0,85,0,0.005586959379518864,0,12231,0,181,126,0,12538,12050,0.005861597848422336,366589,127361,
0,0.0,0,0,0,0,25288,16151,519238,0.0,239228,823,0.06976093468445618,46184,69,0,0,69,63158,0.02585533850322584,-30033,0,69,0,0.004503916449086162,0,12231,0,181,126,0,12538,12050,0.005861597848422336,366589,127361,
0,0.0,0,0,0,0,25288,16151,519238,0.0,239228,823,0.06976093468445618,46184,97,0,0,97,63158,0.02585533850322584,-30033,0,97,0,0.0062766921185453605,0,12231,0,181,126,0,12538,12050,0.005861597848422336,366589,127361,
0,0.0,0,0,0,0,25288,16151,519238,0.0,239228,823,0.06976093468445618,46184,119,0,0,119,63158,0.02585533850322584,-30033,0,119,0,0.007623318385650224,0,12231,0,181,126,0,12538,12050,0.005861597848422336,366589,127361,
0,0.0,0,0,0,0,25288,16151,519238,0.0,239228,823,0.06976093468445618,46184,117,0,0,117,63158,0.02585533850322584,-30033,0,117,0,0.007421974118244101,0,12231,0,181,126,0,12538,12050,0.005861597848422336,366589,127361,
0,0.0,0,0,0,0,25288,16151,519238,0.0,239228,823,0.06976093468445618,46184,69,0,0,69,63158,0.02585533850322584,-30033,0,69,0,0.004347826086956522,0,12231,0,181,126,0,12538,12050,0.005861597848422336,366589,127361,
0,0.0,0,0,0,0,25288,16151,519238,0.0,239228,823,0.06976093468445618,46184,85,0,0,85,63158,0.02585533850322584,-30033,0,85,0,0.005315157578789395,0,12231,0,181,126,0,12538,12050,0.005861597848422336,366589,127361,
0,0.0,0,0,0,0,25288,16151,519238,0.0,239228,823,0.06976093468445618,46184,85,0,0,85,63158,0.02585533850322584,-30033,0,85,0,0.005274916221918828,0,12231,0,181,126,0,12538,12050,0.005861597848422336,366589,127361,
0,0.0,0,0,0,0,25288,16151,519238,0.0,239228,823,0.06976093468445618,46184,69,0,0,69,63158,0.02585533850322584,-30033,0,69,0,0.004254007398273736,0,12231,0,181,126,0,12538,12050,0.005861597848422336,366589,127361,
0,0.0,0,0,0,0,25288,16151,519238,0.0,239228,823,0.06976093468445618,46184,81,0,0,81,63158,0.02585533850322584,-30033,0,81,0,0.004957767168564084,0,12231,0,181,126,0,12538,12050,0.005861597848422336,366589,127361,
0,0.0,0,0,0,0,25288,16151,519238,0.0,239228,823,0.06976093468445618,46184,81,0,0,81,63158,0.02585533850322584,-30033,0,81,0,0.004922216820612542,0,12231,0,181,126,0,12538,12050,0.005861597848422336,366589,127361,
0,0.0,0,0,0,0,25288,16151,519238,0.0,239228,823,0.06976093468445618,46184,81,0,0,81,63158,0.02585533850322584,-30033,0,81,0,0.004922216820612542,0,12231,0,181,126,0,12538,12050,0.005861597848422336,366589,127361,
0,0.0,0,0,0,0,25288,16151,519238,0.0,239228,823,0.06976093468445618,46184,81,0,0,81,63158,0.02585533850322584,-30033,0,81,0,0.004922216820612542,0,12231,0,181,126,0,12538,12050,0.005861597848422336,366589,127361,
0,0.0,0,0,0,0,25288,16151,519238,0.0,239228,823,0.06976093468445618,46184,69,0,0,69,63158,0.02585533850322584,-30033,0,69,0,0.004166163506822847,0,12231,0,181,126,0,12538,12050,0.005861597848422336,366589,127361,
0,0.0,0,0,0,0,25288,16151,519238,0.0,239228,823,0.06976093468445618,46184,69,0,0,69,63158,0.02585533850322584,-30033,0,69,0,0.00413966882649388,0,12231,0,181,126,0,12538,12050,0.005861597848422336,366589,127361,
0,0.0,0,0,0,0,25288,16151,519238,0.0,239228,823,0.06976093468445618,46184,81,0,0,81,63158,0.02585533850322584,-30033,0,81,0,0.00482544977957822,0,12231,0,181,126,0,12538,12050,0.005861597848422336,366589,127361,
0,0.0,0,0,0,0,25288,16151,519238,0.0,239228,823,0.06976093468445618,46184,81,0,0,81,63158,0.02585533850322584,-30033,0,81,0,0.00482544977957822,0,12231,0,181,126,0,12538,12050,0.005861597848422336,366589,127361,
0,0.0,0,0,0,0,25288,16151,519238,0.0,239228,823,0.06976093468445618,46184,81,0,0,81,63158,0.02585533850322584,-30033,0,81,0,0.00482544977957822,0,12231,0,181,126,0,12538,12050,0.005861597848422336,366589,127361,
0,0.0,0,0,0,0,25288,16151,519238,0.0,239228,823,0.06976093468445618,46184,117,0,0,117,63158,0.02585533850322584,-30033,0,117,0,0.006864585777986388,0,12231,0,181,126,0,12538,12050,0.005861597848422336,366589,127361,
0,0.0,0,0,0,0,25288,16151,519238,0.0,239228,823,0.06976093468445618,46184,69,0,0,69,63158,0.02585533850322584,-30033,0,69,0,0.00402332361516035,0,12231,0,181,126,0,12538,12050,0.005861597848422336,366589,127361,
0,0.0,0,0,0,0,25288,16151,519238,0.0,239228,823,0.06976093468445618,46184,111,0,0,111,63158,0.02585533850322584,-30033,0,111,0,0.0064169268123482484,0,12231,0,181,126,0,12538,12050,0.005861597848422336,366589,127361,
0,0.0,0,0,0,0,25288,16151,519238,0.0,239228,823,0.06976093468445618,46184,81,0,0,81,63158,0.02585533850322584,-30033,0,81,0,0.004650895728066146,0,12231,0,181,126,0,12538,12050,0.005861597848422336,366589,127361,
0,0.0,0,0,0,0,25288,16151,519238,0.0,239228,823,0.06976093468445618,46184,94,0,0,94,63158,0.02585533850322584,-30033,0,94,0,0.005357041089644954,0,12231,0,181,126,0,12538,12050,0.005861597848422336,366589,127361,
0,0.0,0,0,0,0,25288,16151,519238,0.0,239228,823,0.06976093468445618,46184,81,0,0,81,63158,0.02585533850322584,-30033,0,81,0,0.004585338239456552,0,12231,0,181,126,0,12538,12050,0.005861597848422336,366589,127361,
0,0.0,0,0,0,0,25288,16151,519238,0.0,239228,823,0.06976093468445618,46184,81,0,0,81,63158,0.02585533850322584,-30033,0,81,0,0.004585338239456552,0,12231,0,181,126,0,12538,12050,0.005861597848422336,366589,127361,
0,0.0,0,0,0,0,25288,16151,519238,0.0,239228,823,0.06976093468445618,46184,81,0,0,81,63158,0.02585533850322584,-30033,0,81,0,0.004585338239456552,0,12231,0,181,126,0,12538,12050,0.005861597848422336,366589,127361,
0,0.0,0,0,0,0,25288,16151,519238,0.0,239228,823,0.06976093468445618,46184,81,0,0,81,63158,0.02585533850322584,-30033,0,81,0,0.004554911994601586,0,12231,0,181,126,0,12538,12050,0.005861597848422336,366589,127361,
0,0.0,0,0,0,0,25288,16151,519238,0.0,239228,823,0.06976093468445618,46184,81,0,0,81,63158,0.02585533850322584,-30033,0,81,0,0.004554911994601586,0,12231,0,181,126,0,12538,12050,0.005861597848422336,366589,127361,
0,0.0,0,0,0,0,25288,16151,519238,0.0,239228,823,0.06976093468445618,46184,81,0,0,81,63158,0.02585533850322584,-30033,0,81,0,0.004554911994601586,0,12231,0,181,126,0,12538,12050,0.005861597848422336,366589,127361,
0,0.0,0,0,0,0,25288,16151,519238,0.0,239228,823,0.06976093468445618,46184,131,0,0,131,63158,0.02585533850322584,-30033,0,131,0,0.007297643585315581,0,12231,0,181,126,0,12538,12050,0.005861597848422336,366589,127361,
0,0.0,0,0,0,0,25288,16151,519238,0.0,239228,823,0.06976093468445618,46184,131,0,0,131,63158,0.02585533850322584,-30033,0,131,0,0.007297643585315581,0,12231,0,181,126,0,12538,12050,0.005861597848422336,366589,127361,
0,0.0,0,0,0,0,25288,16151,519238,0.0,239228,823,0.06976093468445618,46184,131,0,0,131,63158,0.02585533850322584,-30033,0,131,0,0.007297643585315581,0,12231,0,181,126,0,12538,12050,0.005861597848422336,366589,127361,
0,0.0,0,0,0,0,25288,16151,519238,0.0,239228,823,0.06976093468445618,46184,131,0,0,131,63158,0.02585533850322584,-30033,0,131,0,0.007297643585315581,0,12231,0,181,126,0,12538,12050,0.005861597848422336,366589,127361,
0,0.0,0,0,0,0,25288,16151,519238,0.0,239228,823,0.06976093468445618,46184,131,0,0,131,63158,0.02585533850322584,-30033,0,131,0,0.007297643585315581,0,12231,0,181,126,0,12538,12050,0.005861597848422336,366589,127361,
0,0.0,0,0,0,0,25288,16151,519238,0.0,239228,823,0.06976093468445618,46184,120,0,0,120,63158,0.02585533850322584,-30033,0,120,0,0.0066269052352551355,0,12231,0,181,126,0,12538,12050,0.005861597848422336,366589,127361,
0,0.0,0,0,0,0,25288,16151,519238,0.0,239228,823,0.06976093468445618,46184,120,0,0,120,63158,0.02585533850322584,-30033,0,120,0,0.0066269052352551355,0,12231,0,181,126,0,12538,12050,0.005861597848422336,366589,127361,
0,0.0,0,0,0,0,25288,16151,519238,0.0,239228,823,0.06976093468445618,46184,120,0,0,120,63158,0.02585533850322584,-30033,0,120,0,0.0066269052352551355,0,12231,0,181,126,0,12538,12050,0.005861597848422336,366589,127361,
0,0.0,0,0,0,0,25288,16151,519238,0.0,239228,823,0.06976093468445618,46184,104,0,0,104,63158,0.02585533850322584,-30033,0,104,0,0.005698942407803167,0,12231,0,181,126,0,12538,12050,0.005861597848422336,366589,127361,
0,0.0,0,0,0,0,25288,16151,519238,0.0,239228,823,0.06976093468445618,46184,104,0,0,104,63158,0.02585533850322584,-30033,0,104,0,0.005655247417074497,0,12231,0,181,126,0,12538,12050,0.005861597848422336,366589,127361,
0,0.0,0,0,0,0,25288,16151,519238,0.0,239228,823,0.06976093468445618,46184,69,0,0,69,63158,0.02585533850322584,-30033,0,69,0,0.0037305363321799307,0,12231,0,181,126,0,12538,12050,0.005861597848422336,366589,127361,
0,0.0,0,0,0,0,25288,16151,519238,0.0,239228,823,0.06976093468445618,46184,69,0,0,69,63158,0.02585533850322584,-30033,0,69,0,0.003709278572196538,0,12231,0,181,126,0,12538,12050,0.005861597848422336,366589,127361,
0,0.0,0,0,0,0,25288,16151,519238,0.0,239228,823,0.06976093468445618,46184,81,0,0,81,63158,0.02585533850322584,-30033,0,81,0,0.004326923076923077,0,12231,0,181,126,0,12538,12050,0.005861597848422336,366589,127361,
0,0.0,0,0,0,0,25288,16151,519238,0.0,239228,823,0.06976093468445618,46184,69,0,0,69,63158,0.02585533850322584,-30033,0,69,0,0.0036651439498565815,0,12231,0,181,126,0,12538,12050,0.005861597848422336,366589,127361,
0,0.0,0,0,0,0,25288,16151,519238,0.0,239228,823,0.06976093468445618,46184,107,0,0,107,63158,0.02585533850322584,-30033,0,107,0,0.0056404849762783345,0,12231,0,181,126,0,12538,12050,0.005861597848422336,366589,127361,
0,0.0,0,0,0,0,25288,16151,519238,0.0,239228,823,0.06976093468445618,46184,93,0,0,93,63158,0.02585533850322584,-30033,0,93,0,0.004869109947643979,0,12231,0,181,126,0,12538,12050,0.005861597848422336,366589,127361,
0,0.0,0,0,0,0,25288,16151,519238,0.0,239228,823,0.06976093468445618,46184,184,0,0,184,63158,0.02585533850322584,-30033,0,184,0,0.009520852737245162,0,12231,0,181,126,0,12538,12050,0.005861597848422336,366589,127361,
0,0.0,0,0,0,0,25288,16151,519238,0.0,239228,823,0.06976093468445618,46184,69,0,0,69,63158,0.02585533850322584,-30033,0,69,0,0.0035508439687114038,0,12231,0,181,126,0,12538,12050,0.005861597848422336,366589,127361,
0,0.0,0,0,0,0,25288,16151,519238,0.0,239228,823,0.06976093468445618,46184,122,0,0,122,63158,0.02585533850322584,-30033,0,122,0,0.006227031441404655,0,12231,0,181,126,0,12538,12050,0.005861597848422336,366589,127361,
0,0.0,0,0,0,0,25288,16151,519238,0.0,239228,823,0.06976093468445618,46184,69,0,0,69,63158,0.02585533850322584,-30033,0,69,0,0.0035028936947913494,0,12231,0,181,126,0,12538,12050,0.005861597848422336,366589,127361,
0,0.0,0,0,0,0,25288,16151,519238,0.0,239228,823,0.06976093468445618,46184,97,0,0,97,63158,0.02585533850322584,-30033,0,97,0,0.004891085114965712,0,12231,0,181,126,0,12538,12050,0.005861597848422336,366589,127361,
0,0.0,0,0,0,0,25288,16151,519238,0.0,239228,823,0.06976093468445618,46184,98,0,0,98,63158,0.02585533850322584,-30033,0,98,0,0.004908098362297791,0,12231,0,181,126,0,12538,12050,0.005861597848422336,366589,127361,
0,0.0,0,0,0,0,25288,16151,519238,0.0,239228,823,0.06976093468445618,46184,81,0,0,81,63158,0.02585533850322584,-30033,0,81,0,0.004032860343539955,0,12231,0,181,126,0,12538,12050,0.005861597848422336,366589,127361,
0,0.0,0,0,0,0,25288,16151,519238,0.0,239228,823,0.06976093468445618,46184,172,0,0,172,63158,0.02585533850322584,-30033,0,172,0,0.008473741255296088,0,12231,0,181,126,0,12538,12050,0.005861597848422336,366589,127361,
0,0.0,0,0,0,0,25288,16151,519238,0.0,239228,823,0.06976093468445618,46184,81,0,0,81,63158,0.02585533850322584,-30033,0,81,0,0.003967476489028213,0,12231,0,181,126,0,12538,12050,0.005861597848422336,366589,127361,
0,0.0,0,0,0,0,25288,16151,519238,0.0,239228,823,0.06976093468445618,46184,149,0,0,149,63158,0.02585533850322584,-30033,0,149,0,0.0072319565111876915,0,12231,0,181,126,0,12538,12050,0.005861597848422336,366589,127361,
0,0.0,0,0,0,0,25288,16151,519238,0.0,239228,823,0.06976093468445618,46184,93,0,0,93,63158,0.02585533850322584,-30033,0,93,0,0.004485602662422226,0,12231,0,181,126,0,12538,12050,0.005861597848422336,366589,127361,
0,0.0,0,0,0,0,25288,16151,519238,0.0,239228,823,0.06976093468445618,46184,80,0,0,80,63158,0.02585533850322584,-30033,0,80,0,0.0038369304556354917,0,12231,0,181,126,0,12538,12050,0.005861597848422336,366589,127361,
0,0.0,0,0,0,0,25288,16151,519238,0.0,239228,823,0.06976093468445618,46184,148,0,0,148,63158,0.02585533850322584,-30033,0,148,0,0.00703522365356277,0,12231,0,181,126,0,12538,12050,0.005861597848422336,366589,127361,
0,0.0,0,0,0,0,25288,16151,519238,0.0,239228,823,0.06976093468445618,46184,109,0,0,109,63158,0.02585533850322584,-30033,0,109,0,0.005145635651229759,0,12231,0,181,126,0,12538,12050,0.005861597848422336,366589,127361,
0,0.0,0,0,0,0,25288,16151,519238,0.0,239228,823,0.06976093468445618,46184,69,0,0,69,63158,0.02585533850322584,-30033,0,69,0,0.0032411104326177838,0,12231,0,181,126,0,12538,12050,0.005861597848422336,366589,127361,
0,0.0,0,0,0,0,25288,16151,519238,0.0,239228,823,0.06976093468445618,46184,97,0,0,97,63158,0.02585533850322584,-30033,0,97,0,0.0045278439060822484,0,12231,0,181,126,0,12538,12050,0.005861597848422336,366589,127361,
0,0.0,0,0,0,0,25288,16151,519238,0.0,239228,823,0.06976093468445618,46184,119,0,0,119,63158,0.02585533850322584,-30033,0,119,0,0.005514620696047082,0,12231,0,181,126,0,12538,12050,0.005861597848422336,366589,127361,
0,0.0,0,0,0,0,25288,16151,519238,0.0,239228,823,0.06976093468445618,46184,69,0,0,69,63158,0.02585533850322584,-30033,0,69,0,0.0031819229882407195,0,12231,0,181,126,0,12538,12050,0.005861597848422336,366589,127361,
0,0.0,0,0,0,0,25288,16151,519238,0.0,239228,823,0.06976093468445618,46184,94,0,0,94,63158,0.02585533850322584,-30033,0,94,0,0.004308764209754309,0,12231,0,181,126,0,12538,12050,0.005861597848422336,366589,127361,
0,0.0,0,0,0,0,25288,16151,519238,0.0,239228,823,0.06976093468445618,46184,94,0,0,94,63158,0.02585533850322584,-30033,0,94,0,0.004308764209754309,0,12231,0,181,126,0,12538,12050,0.005861597848422336,366589,127361,
0,0.0,0,0,0,0,25288,16151,519238,0.0,239228,823,0.06976093468445618,46184,94,0,0,94,63158,0.02585533850322584,-30033,0,94,0,0.004308764209754309,0,12231,0,181,126,0,12538,12050,0.005861597848422336,366589,127361,
0,0.0,0,0,0,0,25288,16151,519238,0.0,239228,823,0.06976093468445618,46184,94,0,0,94,63158,0.02585533850322584,-30033,0,94,0,0.004308764209754309,0,12231,0,181,126,0,12538,12050,0.005861597848422336,366589,127361,
0,0.0,0,0,0,0,25288,16151,519238,0.0,239228,823,0.06976093468445618,46184,94,0,0,94,63158,0.02585533850322584,-30033,0,94,0,0.004308764209754309,0,12231,0,181,126,0,12538,12050,0.005861597848422336,366589,127361,
0,0.0,0,0,0,0,25288,16151,519238,0.0,239228,823,0.06976093468445618,46184,81,0,0,81,63158,0.02585533850322584,-30033,0,81,0,0.003692896872435488,0,12231,0,181,126,0,12538,12050,0.005861597848422336,366589,127361,
0,0.0,0,0,0,0,25288,16151,519238,0.0,239228,823,0.06976093468445618,46184,94,0,0,94,63158,0.02585533850322584,-30033,0,94,0,0.004260140493995015,0,12231,0,181,126,0,12538,12050,0.005861597848422336,366589,127361,
0,0.0,0,0,0,0,25288,16151,519238,0.0,239228,823,0.06976093468445618,46184,94,0,0,94,63158,0.02585533850322584,-30033,0,94,0,0.004260140493995015,0,12231,0,181,126,0,12538,12050,0.005861597848422336,366589,127361,
0,0.0,0,0,0,0,25288,16151,519238,0.0,239228,823,0.06976093468445618,46184,94,0,0,94,63158,0.02585533850322584,-30033,0,94,0,0.004260140493995015,0,12231,0,181,126,0,12538,12050,0.005861597848422336,366589,127361,
0,0.0,0,0,0,0,25288,16151,519238,0.0,239228,823,0.06976093468445618,46184,81,0,0,81,63158,0.02585533850322584,-30033,0,81,0,0.0036514448000721273,0,12231,0,181,126,0,12538,12050,0.005861597848422336,366589,127361,
0,0.0,0,0,0,0,25288,16151,519238,0.0,239228,823,0.06976093468445618,46184,81,0,0,81,63158,0.02585533850322584,-30033,0,81,0,0.0036514448000721273,0,12231,0,181,126,0,12538,12050,0.005861597848422336,366589,127361,
0,0.0,0,0,0,0,25288,16151,519238,0.0,239228,823,0.06976093468445618,46184,81,0,0,81,63158,0.02585533850322584,-30033,0,81,0,0.0036514448000721273,0,12231,0,181,126,0,12538,12050,0.005861597848422336,366589,127361,
0,0.0,0,0,0,0,25288,16151,519238,0.0,239228,823,0.06976093468445618,46184,160,0,0,160,63158,0.02585533850322584,-30033,0,160,0,0.007148282178438994,0,12231,0,181,126,0,12538,12050,0.005861597848422336,366589,127361,
0,0.0,0,0,0,0,25288,16151,519238,0.0,239228,823,0.06976093468445618,46184,69,0,0,69,63158,0.02585533850322584,-30033,0,69,0,0.003068166659255636,0,12231,0,181,126,0,12538,12050,0.005861597848422336,366589,127361,
0,0.0,0,0,0,0,25288,16151,519238,0.0,239228,823,0.06976093468445618,46184,123,0,0,123,63158,0.02585533850322584,-30033,0,123,0,0.005430703342310919,0,12231,0,181,126,0,12538,12050,0.005861597848422336,366589,127361,
0,0.0,0,0,0,0,25288,16151,519238,0.0,239228,823,0.06976093468445618,46184,80,0,0,80,63158,0.02585533850322584,-30033,0,80,0,0.0035140121233418254,0,12231,0,181,126,0,12538,12050,0.005861597848422336,366589,127361,
0,0.0,0,0,0,0,25288,16151,519238,0.0,239228,823,0.06976093468445618,46184,69,0,0,69,63158,0.02585533850322584,-30033,0,69,0,0.003016789087093389,0,12231,0,181,126,0,12538,12050,0.005861597848422336,366589,127361,
0,0.0,0,0,0,0,25288,16151,519238,0.0,239228,823,0.06976093468445618,46184,81,0,0,81,63158,0.02585533850322584,-30033,0,81,0,0.00352327098738582,0,12231,0,181,126,0,12538,12050,0.005861597848422336,366589,127361,
0,0.0,0,0,0,0,25288,16151,519238,0.0,239228,823,0.06976093468445618,46184,81,0,0,81,63158,0.02585533850322584,-30033,0,81,0,0.00352327098738582,0,12231,0,181,126,0,12538,12050,0.005861597848422336,366589,127361,
0,0.0,0,0,0,0,25288,16151,519238,0.0,239228,823,0.06976093468445618,46184,81,0,0,81,63158,0.02585533850322584,-30033,0,81,0,0.00352327098738582,0,12231,0,181,126,0,12538,12050,0.005861597848422336,366589,127361,
0,0.0,0,0,0,0,25288,16151,519238,0.0,239228,823,0.06976093468445618,46184,109,0,0,109,63158,0.02585533850322584,-30033,0,109,0,0.004711272475795297,0,12231,0,181,126,0,12538,12050,0.005861597848422336,366589,127361,
0,0.0,0,0,0,0,25288,16151,519238,0.0,239228,823,0.06976093468445618,46184,85,0,0,85,63158,0.02585533850322584,-30033,0,85,0,0.0036546564622925446,0,12231,0,181,126,0,12538,12050,0.005861597848422336,366589,127361,
0,0.0,0,0,0,0,25288,16151,519238,0.0,239228,823,0.06976093468445618,46184,93,0,0,93,63158,0.02585533850322584,-30033,0,93,0,0.003976398152898923,0,12231,0,181,126,0,12538,12050,0.005861597848422336,366589,127361,
0,0.0,0,0,0,0,25288,16151,519238,0.0,239228,823,0.06976093468445618,46184,94,0,0,94,63158,0.02585533850322584,-30033,0,94,0,0.003996768570092265,0,12231,0,181,126,0,12538,12050,0.005861597848422336,366589,127361,
0,0.0,0,0,0,0,25288,16151,519238,0.0,239228,823,0.06976093468445618,46184,94,0,0,94,63158,0.02585533850322584,-30033,0,94,0,0.003996768570092265,0,12231,0,181,126,0,12538,12050,0.005861597848422336,366589,127361,
0,0.0,0,0,0,0,25288,16151,519238,0.0,239228,823,0.06976093468445618,46184,94,0,0,94,63158,0.02585533850322584,-30033,0,94,0,0.003996768570092265,0,12231,0,181,126,0,12538,12050,0.005861597848422336,366589,127361,
0,0.0,0,0,0,0,25288,16151,519238,0.0,239228,823,0.06976093468445618,46184,351,0,0,351,63158,0.02585533850322584,-30033,0,351,0,0.014680664185034924,0,12231,0,181,126,0,12538,12050,0.005861597848422336,366589,127361,
0,0.0,0,0,0,0,25288,16151,519238,0.0,239228,823,0.06976093468445618,46184,351,0,0,351,63158,0.02585533850322584,-30033,0,351,0,0.014680664185034924,0,12231,0,181,126,0,12538,12050,0.005861597848422336,366589,127361,
0,0.0,0,0,0,0,25288,16151,519238,0.0,239228,823,0.06976093468445618,46184,351,0,0,351,63158,0.02585533850322584,-30033,0,351,0,0.014680664185034924,0,12231,0,181,126,0,12538,12050,0.005861597848422336,366589,127361,
0,0.0,0,0,0,0,25288,16151,519238,0.0,239228,823,0.06976093468445618,46184,351,0,0,351,63158,0.02585533850322584,-30033,0,351,0,0.014680664185034924,0,12231,0,181,126,0,12538,12050,0.005861597848422336,366589,127361,
0,0.0,0,0,0,0,25288,16151,519238,0.0,239228,823,0.06976093468445618,46184,4,51,125,180,63158,0.02585533850322584,-30033,0,-47,0,0.006097807352132675,0,12231,0,181,126,0,12538,12050,0.005861597848422336,366589,127361,
0,0.0,0,0,0,0,25288,16151,519238,0.0,239228,823,0.06976093468445618,46184,4,51,125,180,63158,0.02585533850322584,-30033,0,-47,0,0.006097807352132675,0,12231,0,181,126,0,12538,12050,0.005861597848422336,366589,127361,
0,0.0,0,0,0,0,25288,16151,519238,0.0,239228,823,0.06976093468445618,46184,149,0,0,149,63158,0.02585533850322584,-30033,0,149,0,0.005789330535804484,0,12231,0,181,126,0,12538,12050,0.005861597848422336,366589,127361,
0,0.0,0,0,0,0,25288,16151,519238,0.0,239228,823,0.06976093468445618,46184,69,0,0,69,63158,0.02585533850322584,-30033,0,69,0,0.00266996865688968,0,12231,0,181,126,0,12538,12050,0.005861597848422336,366589,127361,
0,0.0,0,0,0,0,25288,16151,519238,0.0,239228,823,0.06976093468445618,46184,171,0,0,171,63158,0.02585533850322584,-30033,0,171,0,0.006562787841571999,0,12231,0,181,126,0,12538,12050,0.005861597848422336,366589,127361,
0,0.0,0,0,0,0,25288,16151,519238,0.0,239228,823,0.06976093468445618,46184,105,0,0,105,63158,0.02585533850322584,-30033,0,105,0,0.004007939537369265,0,12231,0,181,126,0,12538,12050,0.005861597848422336,366589,127361,
0,0.0,0,0,0,0,25288,16151,519238,0.0,239228,823,0.06976093468445618,46184,134,0,0,134,63158,0.02585533850322584,-30033,0,134,0,0.0050813393500436085,0,12231,0,181,126,0,12538,12050,0.005861597848422336,366589,127361,
0,0.0,0,0,0,0,25288,16151,519238,0.0,239228,823,0.06976093468445618,46184,80,0,0,80,63158,0.02585533850322584,-30033,0,80,0,0.0030202355783751134,0,12231,0,181,126,0,12538,12050,0.005861597848422336,366589,127361,
0,0.0,0,0,0,0,25288,16151,519238,0.0,239228,823,0.06976093468445618,46184,110,0,0,110,63158,0.02585533850322584,-30033,0,110,0,0.004129904261310306,0,12231,0,181,126,0,12538,12050,0.005861597848422336,366589,127361,
0,0.0,0,0,0,0,25288,16151,519238,0.0,239228,823,0.06976093468445618,46184,80,0,0,80,63158,0.02585533850322584,-30033,0,80,0,0.0029904306220095694,0,12231,0,181,126,0,12538,12050,0.005861597848422336,366589,127361,
0,0.0,0,0,0,0,25288,16151,519238,0.0,239228,823,0.06976093468445618,46184,132,0,0,132,63158,0.02585533850322584,-30033,0,132,0,0.00490323539244456,0,12231,0,181,126,0,12538,12050,0.005861597848422336,366589,127361,
0,0.0,0,0,0,0,25288,16151,519238,0.0,239228,823,0.06976093468445618,46184,69,0,0,69,63158,0.02585533850322584,-30033,0,69,0,0.002553002553002553,0,12231,0,181,126,0,12538,12050,0.005861597848422336,366589,127361,
0,0.0,0,0,0,0,25288,16151,519238,0.0,239228,823,0.06976093468445618,46184,98,0,0,98,63158,0.02585533850322584,-30033,0,98,0,0.0035931656522695606,0,12231,0,181,126,0,12538,12050,0.005861597848422336,366589,127361,
0,0.0,0,0,0,0,25288,16151,519238,0.0,239228,823,0.06976093468445618,46184,81,0,0,81,63158,0.02585533850322584,-30033,0,81,0,0.0029570677570093457,0,12231,0,181,126,0,12538,12050,0.005861597848422336,366589,127361,
0,0.0,0,0,0,0,25288,16151,519238,0.0,239228,823,0.06976093468445618,46184,160,0,0,160,63158,0.02585533850322584,-30033,0,160,0,0.0057987822557262975,0,12231,0,181,126,0,12538,12050,0.005861597848422336,366589,127361,
0,0.0,0,0,0,0,25288,16151,519238,0.0,239228,823,0.06976093468445618,46184,81,0,0,81,63158,0.02585533850322584,-30033,0,81,0,0.002923132443161314,0,12231,0,181,126,0,12538,12050,0.005861597848422336,366589,127361,
0,0.0,0,0,0,0,25288,16151,519238,0.0,239228,823,0.06976093468445618,46184,119,0,0,119,63158,0.02585533850322584,-30033,0,119,0,0.004270437091796454,0,12231,0,181,126,0,12538,12050,0.005861597848422336,366589,127361,
0,0.0,0,0,0,0,25288,16151,519238,0.0,239228,823,0.06976093468445618,46184,135,0,0,135,63158,0.02585533850322584,-30033,0,135,0,0.004814722351011091,0,12231,0,181,126,0,12538,12050,0.005861597848422336,366589,127361,
0,0.0,0,0,0,0,25288,16151,519238,0.0,239228,823,0.06976093468445618,46184,121,0,0,121,63158,0.02585533850322584,-30033,0,121,0,0.004291236656381885,0,12231,0,181,126,0,12538,12050,0.005861597848422336,366589,127361,
0,0.0,0,0,0,0,25288,16151,519238,0.0,239228,823,0.06976093468445618,46184,69,0,0,69,63158,0.02585533850322584,-30033,0,69,0,0.0024379041091050417,0,12231,0,181,126,0,12538,12050,0.005861597848422336,366589,127361,
0,0.0,0,0,0,0,25288,16151,519238,0.0,239228,823,0.06976093468445618,46184,119,0,0,119,63158,0.02585533850322584,-30033,0,119,0,0.0041814540215748975,0,12231,0,181,126,0,12538,12050,0.005861597848422336,366589,127361,
0,0.0,0,0,0,0,25288,16151,519238,0.0,239228,823,0.06976093468445618,46184,81,0,0,81,63158,0.02585533850322584,-30033,0,81,0,0.002834447282779858,0,12231,0,181,126,0,12538,12050,0.005861597848422336,366589,127361,
0,0.0,0,0,0,0,25288,16151,519238,0.0,239228,823,0.06976093468445618,46184,69,0,0,69,63158,0.02585533850322584,-30033,0,69,0,0.0024056061081476833,0,12231,0,181,126,0,12538,12050,0.005861597848422336,366589,127361,
0,0.0,0,0,0,0,25288,16151,519238,0.0,239228,823,0.06976093468445618,46184,69,0,0,69,63158,0.02585533850322584,-30033,0,69,0,0.0023967487582062593,0,12231,0,181,126,0,12538,12050,0.005861597848422336,366589,127361,
0,0.0,0,0,0,0,25288,16151,519238,0.0,239228,823,0.06976093468445618,46184,69,0,0,69,63158,0.02585533850322584,-30033,0,69,0,0.0023879563938397647,0,12231,0,181,126,0,12538,12050,0.005861597848422336,366589,127361,
0,0.0,0,0,0,0,25288,16151,519238,0.0,239228,823,0.06976093468445618,46184,69,0,0,69,63158,0.02585533850322584,-30033,0,69,0,0.0023792283024723286,0,12231,0,181,126,0,12538,12050,0.005861597848422336,366589,127361,
0,0.0,0,0,0,0,25288,16151,519238,0.0,239228,823,0.06976093468445618,46184,69,0,0,69,63158,0.02585533850322584,-30033,0,69,0,0.002370563781908132,0,12231,0,181,126,0,12538,12050,0.005861597848422336,366589,127361,
0,0.0,0,0,0,0,25288,16151,519238,0.0,239228,823,0.06976093468445618,46184,69,0,0,69,63158,0.02585533850322584,-30033,0,69,0,0.002361962140143087,0,12231,0,181,126,0,12538,12050,0.005861597848422336,366589,127361,
0,0.0,0,0,0,0,25288,16151,519238,0.0,239228,823,0.06976093468445618,46184,97,0,0,97,63158,0.02585533850322584,-30033,0,97,0,0.003305278222646267,0,6421,0,51,0,0,6472,6370,0.0037470979081805546,366589,127361,
0,0.0,0,0,0,0,25288,16151,519238,0.0,239228,823,0.06976093468445618,46184,98,0,0,98,63158,0.02585533850322584,-30033,0,98,0,0.00332406213961061,0,6421,0,51,0,0,6472,6370,0.0037470979081805546,366589,127361,
0,0.0,0,0,0,0,25288,16151,519238,0.0,239228,823,0.06976093468445618,46184,81,0,0,81,63158,0.02585533850322584,-30033,0,81,0,0.0027364864864864863,0,6421,0,51,0,0,6472,6370,0.0037470979081805546,366589,127361,
0,0.0,0,0,0,0,25288,16151,519238,0.0,239228,823,0.06976093468445618,46184,172,0,0,172,63158,0.02585533850322584,-30033,0,172,0,0.005769295273873813,0,6421,0,51,0,0,6472,6370,0.0037470979081805546,366589,127361,
0,0.0,0,0,0,0,25288,16151,519238,0.0,239228,823,0.06976093468445618,46184,81,0,0,81,63158,0.02585533850322584,-30033,0,81,0,0.0027062243159266313,0,6421,0,51,0,0,6472,6370,0.0037470979081805546,366589,127361,
0,0.0,0,0,0,0,25288,16151,519238,0.0,239228,823,0.06976093468445618,46184,136,0,0,136,63158,0.02585533850322584,-30033,0,136,0,0.004517522006311244,0,6421,0,51,0,0,6472,6370,0.0037470979081805546,366589,127361,
0,0.0,0,0,0,0,25288,16151,519238,0.0,239228,823,0.06976093468445618,46184,110,0,0,110,63158,0.02585533850322584,-30033,0,110,0,0.003636123231521883,0,6421,0,51,0,0,6472,6370,0.0037470979081805546,366589,127361,
0,0.0,0,0,0,0,25288,16151,519238,0.0,239228,823,0.06976093468445618,46184,81,0,0,81,63158,0.02585533850322584,-30033,0,81,0,0.002667105696410932,0,6421,0,51,0,0,6472,6370,0.0037470979081805546,366589,127361,
0,0.0,0,0,0,0,25288,16151,519238,0.0,239228,823,0.06976093468445618,46184,135,0,0,135,63158,0.02585533850322584,-30033,0,135,0,0.004419998035556429,0,6421,0,51,0,0,6472,6370,0.0037470979081805546,366589,127361,
0,0.0,0,0,0,0,25288,16151,519238,0.0,239228,823,0.06976093468445618,46184,135,0,0,135,63158,0.02585533850322584,-30033,0,135,0,0.0043951035291053524,0,6421,0,51,0,0,6472,6370,0.0037470979081805546,366589,127361,
0,0.0,0,0,0,0,25288,16151,519238,0.0,239228,823,0.06976093468445618,46184,109,0,0,109,63158,0.02585533850322584,-30033,0,109,0,0.003531851467824509,0,6421,0,51,0,0,6472,6370,0.0037470979081805546,366589,127361,
0,0.0,0,0,0,0,25288,16151,519238,0.0,239228,823,0.06976093468445618,46184,69,0,0,69,63158,0.02585533850322584,-30033,0,69,0,0.002228106432446396,0,6421,0,51,0,0,6472,6370,0.0037470979081805546,366589,127361,
0,0.0,0,0,0,0,25288,16151,519238,0.0,239228,823,0.06976093468445618,46184,85,0,0,85,63158,0.02585533850322584,-30033,0,85,0,0.002733998070119009,0,6421,0,51,0,0,6472,6370,0.0037470979081805546,366589,127361,
0,0.0,0,0,0,0,25288,16151,519238,0.0,239228,823,0.06976093468445618,46184,85,0,0,85,63158,0.02585533850322584,-30033,0,85,0,0.0027233115468409588,0,6421,0,51,0,0,6472,6370,0.0037470979081805546,366589,127361,
0,0.0,0,0,0,0,25288,16151,519238,0.0,239228,823,0.06976093468445618,46184,69,0,0,69,63158,0.02585533850322584,-30033,0,69,0,0.0022032058241267002,0,6421,0,51,0,0,6472,6370,0.0037470979081805546,366589,127361,
0,0.0,0,0,0,0,25288,16151,519238,0.0,239228,823,0.06976093468445618,46184,97,0,0,97,63158,0.02585533850322584,-30033,0,97,0,0.0030840646063843317,0,6421,0,51,0,0,6472,6370,0.0037470979081805546,366589,127361,
0,0.0,0,0,0,0,25288,16151,519238,0.0,239228,823,0.06976093468445618,46184,119,0,0,119,63158,0.02585533850322584,-30033,0,119,0,0.0037648696532523412,0,6421,0,51,0,0,6472,6370,0.0037470979081805546,366589,127361,
0,0.0,0,0,0,0,25288,16151,519238,0.0,239228,823,0.06976093468445618,46184,117,0,0,117,63158,0.02585533850322584,-30033,0,117,0,0.0036836471254958754,0,6421,0,51,0,0,6472,6370,0.0037470979081805546,366589,127361,
0,0.0,0,0,0,0,25288,16151,519238,0.0,239228,823,0.06976093468445618,46184,69,0,0,69,63158,0.02585533850322584,-30033,0,69,0,0.002165181373164303,0,6421,0,51,0,0,6472,6370,0.0037470979081805546,366589,127361,
0,0.0,0,0,0,0,25288,16151,519238,0.0,239228,823,0.06976093468445618,46184,85,0,0,85,63158,0.02585533850322584,-30033,0,85,0,0.0026570803376055017,0,6421,0,51,0,0,6472,6370,0.0037470979081805546,366589,127361,
0,0.0,0,0,0,0,25288,16151,519238,0.0,239228,823,0.06976093468445618,46184,85,0,0,85,63158,0.02585533850322584,-30033,0,85,0,0.0026469855505729945,0,6421,0,51,0,0,6472,6370,0.0037470979081805546,366589,127361,
0,0.0,0,0,0,0,25288,16151,519238,0.0,239228,823,0.06976093468445618,46184,81,0,0,81,63158,0.02585533850322584,-30033,0,81,0,0.002513186472230841,0,6421,0,51,0,0,6472,6370,0.0037470979081805546,366589,127361,
0,0.0,0,0,0,0,25288,16151,519238,0.0,239228,823,0.06976093468445618,46184,81,0,0,81,63158,0.02585533850322584,-30033,0,81,0,0.002504018795597873,0,6421,0,51,0,0,6472,6370,0.0037470979081805546,366589,127361,
0,0.0,0,0,0,0,25288,16151,519238,0.0,239228,823,0.06976093468445618,46184,81,0,0,81,63158,0.02585533850322584,-30033,0,81,0,0.002504018795597873,0,6421,0,51,0,0,6472,6370,0.0037470979081805546,366589,127361,
0,0.0,0,0,0,0,25288,16151,519238,0.0,239228,823,0.06976093468445618,46184,81,0,0,81,63158,0.02585533850322584,-30033,0,81,0,0.002504018795597873,0,6421,0,51,0,0,6472,6370,0.0037470979081805546,366589,127361,
0,0.0,0,0,0,0,25288,16151,519238,0.0,239228,823,0.06976093468445618,46184,117,0,0,117,63158,0.02585533850322584,-30033,0,117,0,0.0035916011787819253,0,6421,0,51,0,0,6472,6370,0.0037470979081805546,366589,127361,
0,0.0,0,0,0,0,25288,16151,519238,0.0,239228,823,0.06976093468445618,46184,69,0,0,69,63158,0.02585533850322584,-30033,0,69,0,0.002111253901230035,0,6421,0,51,0,0,6472,6370,0.0037470979081805546,366589,127361,
0,0.0,0,0,0,0,25288,16151,519238,0.0,239228,823,0.06976093468445618,46184,111,0,0,111,63158,0.02585533850322584,-30033,0,111,0,0.0033810539141029545,0,6421,0,51,0,0,6472,6370,0.0037470979081805546,366589,127361,
0,0.0,0,0,0,0,25288,16151,519238,0.0,239228,823,0.06976093468445618,46184,81,0,0,81,63158,0.02585533850322584,-30033,0,81,0,0.0024584193274250336,0,6421,0,51,0,0,6472,6370,0.0037470979081805546,366589,127361,
0,0.0,0,0,0,0,25288,16151,519238,0.0,239228,823,0.06976093468445618,46184,81,0,0,81,63158,0.02585533850322584,-30033,0,81,0,0.0024496461622210124,0,6421,0,51,0,0,6472,6370,0.0037470979081805546,366589,127361,
0,0.0,0,0,0,0,25288,16151,519238,0.0,239228,823,0.06976093468445618,46184,81,0,0,81,63158,0.02585533850322584,-30033,0,81,0,0.0024496461622210124,0,6421,0,51,0,0,6472,6370,0.0037470979081805546,366589,127361,
0,0.0,0,0,0,0,25288,16151,519238,0.0,239228,823,0.06976093468445618,46184,81,0,0,81,63158,0.02585533850322584,-30033,0,81,0,0.0024496461622210124,0,6421,0,51,0,0,6472,6370,0.0037470979081805546,366589,127361,
0,0.0,0,0,0,0,25288,16151,519238,0.0,239228,823,0.06976093468445618,46184,81,0,0,81,63158,0.02585533850322584,-30033,0,81,0,0.0024409353905496625,0,6421,0,51,0,0,6472,6370,0.0037470979081805546,366589,127361,
0,0.0,0,0,0,0,25288,16151,519238,0.0,239228,823,0.06976093468445618,46184,81,0,0,81,63158,0.02585533850322584,-30033,0,81,0,0.0024409353905496625,0,6421,0,51,0,0,6472,6370,0.0037470979081805546,366589,127361,
0,0.0,0,0,0,0,25288,16151,519238,0.0,239228,823,0.06976093468445618,46184,81,0,0,81,63158,0.02585533850322584,-30033,0,81,0,0.0024409353905496625,0,6421,0,51,0,0,6472,6370,0.0037470979081805546,366589,127361,
0,0.0,0,0,0,0,25288,16151,519238,0.0,239228,823,0.06976093468445618,46184,131,0,0,131,63158,0.02585533850322584,-30033,0,131,0,0.0039278004317582155,0,6421,0,51,0,0,6472,6370,0.0037470979081805546,366589,127361,
0,0.0,0,0,0,0,25288,16151,519238,0.0,239228,823,0.06976093468445618,46184,131,0,0,131,63158,0.02585533850322584,-30033,0,131,0,0.0039278004317582155,0,6421,0,51,0,0,6472,6370,0.0037470979081805546,366589,127361,
0,0.0,0,0,0,0,25288,16151,519238,0.0,239228,823,0.06976093468445618,46184,131,0,0,131,63158,0.02585533850322584,-30033,0,131,0,0.0039278004317582155,0,6421,0,51,0,0,6472,6370,0.0037470979081805546,366589,127361,
0,0.0,0,0,0,0,25288,16151,519238,0.0,239228,823,0.06976093468445618,46184,131,0,0,131,63158,0.02585533850322584,-30033,0,131,0,0.0039278004317582155,0,6421,0,51,0,0,6472,6370,0.0037470979081805546,366589,127361,
0,0.0,0,0,0,0,25288,16151,519238,0.0,239228,823,0.06976093468445618,46184,131,0,0,131,63158,0.02585533850322584,-30033,0,131,0,0.0039278004317582155,0,6421,0,51,0,0,6472,6370,0.0037470979081805546,366589,127361,
0,0.0,0,0,0,0,25288,16151,519238,0.0,239228,823,0.06976093468445618,46184,120,0,0,120,63158,0.02585533850322584,-30033,0,120,0,0.0035811274582947866,0,6421,0,51,0,0,6472,6370,0.0037470979081805546,366589,127361,
0,0.0,0,0,0,0,25288,16151,519238,0.0,239228,823,0.06976093468445618,46184,120,0,0,120,63158,0.02585533850322584,-30033,0,120,0,0.0035811274582947866,0,6421,0,51,0,0,6472,6370,0.0037470979081805546,366589,127361,
0,0.0,0,0,0,0,25288,16151,519238,0.0,239228,823,0.06976093468445618,46184,120,0,0,120,63158,0.02585533850322584,-30033,0,120,0,0.0035811274582947866,0,6421,0,51,0,0,6472,6370,0.0037470979081805546,366589,127361,
0,0.0,0,0,0,0,25288,16151,519238,0.0,239228,823,0.06976093468445618,46184,104,0,0,104,63158,0.02585533850322584,-30033,0,104,0,0.0030906389301634473,0,6421,0,51,0,0,6472,6370,0.0037470979081805546,366589,127361,
0,0.0,0,0,0,0,25288,16151,519238,0.0,239228,823,0.06976093468445618,46184,104,0,0,104,63158,0.02585533850322584,-30033,0,104,0,0.0030777425941818826,0,6421,0,51,0,0,6472,6370,0.0037470979081805546,366589,127361,
0,0.0,0,0,0,0,25288,16151,519238,0.0,239228,823,0.06976093468445618,46184,107,0,0,107,63158,0.02585533850322584,-30033,0,107,0,0.0031530867835567996,0,6421,0,51,0,0,6472,6370,0.0037470979081805546,366589,127361,
0,0.0,0,0,0,0,25288,16151,519238,0.0,239228,823,0.06976093468445618,46184,93,0,0,93,63158,0.02585533850322584,-30033,0,93,0,0.0027300748568912375,0,6421,0,51,0,0,6472,6370,0.0037470979081805546,366589,127361,
0,0.0,0,0,0,0,25288,16151,519238,0.0,239228,823,0.06976093468445618,46184,184,0,0,184,63158,0.02585533850322584,-30033,0,184,0,0.005365839433087399,0,6421,0,51,0,0,6472,6370,0.0037470979081805546,366589,127361,
0,0.0,0,0,0,0,25288,16151,519238,0.0,239228,823,0.06976093468445618,46184,69,0,0,69,63158,0.02585533850322584,-30033,0,69,0,0.002005988894380324,0,6421,0,51,0,0,6472,6370,0.0037470979081805546,366589,127361,
0,0.0,0,0,0,0,25288,16151,519238,0.0,239228,823,0.06976093468445618,46184,122,0,0,122,63158,0.02585533850322584,-30033,0,122,0,0.003530399050843534,0,6421,0,51,0,0,6472,6370,0.0037470979081805546,366589,127361,
0,0.0,0,0,0,0,25288,16151,519238,0.0,239228,823,0.06976093468445618,46184,69,0,0,69,63158,0.02585533850322584,-30033,0,69,0,0.0019905951591033667,0,6421,0,51,0,0,6472,6370,0.0037470979081805546,366589,127361,
0,0.0,0,0,0,0,25288,16151,519238,0.0,239228,823,0.06976093468445618,46184,92,51,0,143,63158,0.02585533850322584,-30033,0,41,0,0.02320502465600702,0,6421,0,51,0,0,6472,6370,0.0037470979081805546,366589,127361,
0,0.0,0,0,0,0,25288,16151,519238,0.0,239228,823,0.06976093468445618,46184,92,51,0,143,63158,0.02585533850322584,-30033,0,41,0,0.02320502465600702,0,6421,0,51,0,0,6472,6370,0.0037470979081805546,366589,127361,
0,0.0,0,0,0,0,25288,16151,519238,0.0,239228,823,0.06976093468445618,46184,149,0,0,149,63158,0.02585533850322584,-30033,0,149,0,0.004164686809961707,0,6421,0,51,0,0,6472,6370,0.0037470979081805546,366589,127361,
0,0.0,0,0,0,0,25288,16151,519238,0.0,239228,823,0.06976093468445618,46184,69,0,0,69,63158,0.02585533850322584,-30033,0,69,0,0.0019229161441351058,0,6421,0,51,0,0,6472,6370,0.0037470979081805546,366589,127361,
0,0.0,0,0,0,0,25288,16151,519238,0.0,239228,823,0.06976093468445618,46184,171,0,0,171,63158,0.02585533850322584,-30033,0,171,0,0.004737367021276596,0,6421,0,51,0,0,6472,6370,0.0037470979081805546,366589,127361,
0,0.0,0,0,0,0,25288,16151,519238,0.0,239228,823,0.06976093468445618,46184,105,0,0,105,63158,0.02585533850322584,-30033,0,105,0,0.002897510900160053,0,6421,0,51,0,0,6472,6370,0.0037470979081805546,366589,127361,
0,0.0,0,0,0,0,25288,16151,519238,0.0,239228,823,0.06976093468445618,46184,134,0,0,134,63158,0.02585533850322584,-30033,0,134,0,0.0036802065309933813,0,6421,0,51,0,0,6472,6370,0.0037470979081805546,366589,127361,
0,0.0,0,0,0,0,25288,16151,519238,0.0,239228,823,0.06976093468445618,46184,80,0,0,80,63158,0.02585533850322584,-30033,0,80,0,0.002190100744634253,0,6421,0,51,0,0,6472,6370,0.0037470979081805546,366589,127361,
0,0.0,0,0,0,0,25288,16151,519238,0.0,239228,823,0.06976093468445618,46184,110,0,0,110,63158,0.02585533850322584,-30033,0,110,0,0.0029993183367416497,0,6421,0,51,0,0,6472,6370,0.0037470979081805546,366589,127361,
0,0.0,0,0,0,0,25288,16151,519238,0.0,239228,823,0.06976093468445618,46184,80,0,0,80,63158,0.02585533850322584,-30033,0,80,0,0.0021743857360295715,0,6421,0,51,0,0,6472,6370,0.0037470979081805546,366589,127361,
0,0.0,0,0,0,0,25288,16151,519238,0.0,239228,823,0.06976093468445618,46184,132,0,0,132,63158,0.02585533850322584,-30033,0,132,0,0.0035713319444820217,0,6421,0,51,0,0,6472,6370,0.0037470979081805546,366589,127361,
0,0.0,0,0,0,0,25288,16151,519238,0.0,239228,823,0.06976093468445618,46184,69,0,0,69,63158,0.02585533850322584,-30033,0,69,0,0.0018614940513124881,0,6421,0,51,0,0,6472,6370,0.0037470979081805546,366589,127361,
0,0.0,0,0,0,0,25288,16151,519238,0.0,239228,823,0.06976093468445618,46184,69,0,0,69,63158,0.02585533850322584,-30033,0,69,0,0.0018523987221133454,0,6421,0,51,0,0,6472,6370,0.0037470979081805546,366589,127361,
0,0.0,0,0,0,0,25288,16151,519238,0.0,239228,823,0.06976093468445618,46184,69,0,0,69,63158,0.02585533850322584,-30033,0,69,0,0.0018471422834961853,0,6421,0,51,0,0,6472,6370,0.0037470979081805546,366589,127361,
0,0.0,0,0,0,0,25288,16151,519238,0.0,239228,823,0.06976093468445618,46184,69,0,0,69,63158,0.02585533850322584,-30033,0,69,0,0.0018419155922159045,0,6421,0,51,0,0,6472,6370,0.0037470979081805546,366589,127361,
0,0.0,0,0,0,0,25288,16151,519238,0.0,239228,823,0.06976093468445618,46184,69,0,0,69,63158,0.02585533850322584,-30033,0,69,0,0.0018367183964649826,0,6421,0,51,0,0,6472,6370,0.0037470979081805546,366589,127361,
0,0.0,0,0,0,0,25288,16151,519238,0.0,239228,823,0.06976093468445618,46184,69,0,0,69,63158,0.02585533850322584,-30033,0,69,0,0.001831550447269928,0,6421,0,51,0,0,6472,6370,0.0037470979081805546,366589,127361,
0,0.0,0,0,0,0,25288,16151,519238,0.0,239228,823,0.06976093468445618,46184,69,0,0,69,63158,0.02585533850322584,-30033,0,69,0,0.0018264114984515207,0,6421,0,51,0,0,6472,6370,0.0037470979081805546,366589,127361,
0,0.0,0,0,0,0,25288,16151,519238,0.0,239228,823,0.06976093468445618,46184,146,0,0,146,63158,0.02585533850322584,-30033,0,146,0,0.003845546014855397,0,10841,0,206,0,0,11047,10635,0.0031524866343501973,366589,127361,
0,0.0,0,0,0,0,25288,16151,519238,0.0,239228,823,0.06976093468445618,46184,80,0,0,80,63158,0.02585533850322584,-30033,0,80,0,0.002100674841792926,0,10841,0,206,0,0,11047,10635,0.0031524866343501973,366589,127361,
0,0.0,0,0,0,0,25288,16151,519238,0.0,239228,823,0.06976093468445618,46184,97,0,0,97,63158,0.02585533850322584,-30033,0,97,0,0.0025381374780856685,0,10841,0,206,0,0,11047,10635,0.0031524866343501973,366589,127361,
0,0.0,0,0,0,0,25288,16151,519238,0.0,239228,823,0.06976093468445618,46184,98,0,0,98,63158,0.02585533850322584,-30033,0,98,0,0.0025552774301209847,0,10841,0,206,0,0,11047,10635,0.0031524866343501973,366589,127361,
0,0.0,0,0,0,0,25288,16151,519238,0.0,239228,823,0.06976093468445618,46184,81,0,0,81,63158,0.02585533850322584,-30033,0,81,0,0.00210553678190798,0,10841,0,206,0,0,11047,10635,0.0031524866343501973,366589,127361,
0,0.0,0,0,0,0,25288,16151,519238,0.0,239228,823,0.06976093468445618,46184,172,0,0,172,63158,0.02585533850322584,-30033,0,172,0,0.004446397642375204,0,10841,0,206,0,0,11047,10635,0.0031524866343501973,366589,127361,
0,0.0,0,0,0,0,25288,16151,519238,0.0,239228,823,0.06976093468445618,46184,81,0,0,81,63158,0.02585533850322584,-30033,0,81,0,0.002087575062498389,0,10841,0,206,0,0,11047,10635,0.0031524866343501973,366589,127361,
0,0.0,0,0,0,0,25288,16151,519238,0.0,239228,823,0.06976093468445618,46184,136,0,0,136,63158,0.02585533850322584,-30033,0,136,0,0.003489416292495189,0,10841,0,206,0,0,11047,10635,0.0031524866343501973,366589,127361,
0,0.0,0,0,0,0,25288,16151,519238,0.0,239228,823,0.06976093468445618,46184,110,0,0,110,63158,0.02585533850322584,-30033,0,110,0,0.002811717192372578,0,10841,0,206,0,0,11047,10635,0.0031524866343501973,366589,127361,
0,0.0,0,0,0,0,25288,16151,519238,0.0,239228,823,0.06976093468445618,46184,81,0,0,81,63158,0.02585533850322584,-30033,0,81,0,0.0020642201834862386,0,10841,0,206,0,0,11047,10635,0.0031524866343501973,366589,127361,
0,0.0,0,0,0,0,25288,16151,519238,0.0,239228,823,0.06976093468445618,46184,135,0,0,135,63158,0.02585533850322584,-30033,0,135,0,0.0034252657752518205,0,10841,0,206,0,0,11047,10635,0.0031524866343501973,366589,127361,
0,0.0,0,0,0,0,25288,16151,519238,0.0,239228,823,0.06976093468445618,46184,135,0,0,135,63158,0.02585533850322584,-30033,0,135,0,0.0034102965694942657,0,10841,0,206,0,0,11047,10635,0.0031524866343501973,366589,127361,
0,0.0,0,0,0,0,25288,16151,519238,0.0,239228,823,0.06976093468445618,46184,109,0,0,109,63158,0.02585533850322584,-30033,0,109,0,0.0027433806503573944,0,10841,0,206,0,0,11047,10635,0.0031524866343501973,366589,127361,
0,0.0,0,0,0,0,25288,16151,519238,0.0,239228,823,0.06976093468445618,46184,69,0,0,69,63158,0.02585533850322584,-30033,0,69,0,0.0017320146593704504,0,10841,0,206,0,0,11047,10635,0.0031524866343501973,366589,127361,
0,0.0,0,0,0,0,25288,16151,519238,0.0,239228,823,0.06976093468445618,46184,85,0,0,85,63158,0.02585533850322584,-30033,0,85,0,0.0021271271271271273,0,10841,0,206,0,0,11047,10635,0.0031524866343501973,366589,127361,
0,0.0,0,0,0,0,25288,16151,519238,0.0,239228,823,0.06976093468445618,46184,69,0,0,69,63158,0.02585533850322584,-30033,0,69,0,0.001722158438576349,0,10841,0,206,0,0,11047,10635,0.0031524866343501973,366589,127361,
0,0.0,0,0,0,0,25288,16151,519238,0.0,239228,823,0.06976093468445618,46184,97,0,0,97,63158,0.02585533850322584,-30033,0,97,0,0.0024129353233830844,0,10841,0,206,0,0,11047,10635,0.0031524866343501973,366589,127361,
0,0.0,0,0,0,0,25288,16151,519238,0.0,239228,823,0.06976093468445618,46184,119,0,0,119,63158,0.02585533850322584,-30033,0,119,0,0.002948756070968381,0,10841,0,206,0,0,11047,10635,0.0031524866343501973,366589,127361,
0,0.0,0,0,0,0,25288,16151,519238,0.0,239228,823,0.06976093468445618,46184,106,0,0,106,63158,0.02585533850322584,-30033,0,106,0,0.002617348576508062,0,10841,0,206,0,0,11047,10635,0.0031524866343501973,366589,127361,
0,0.0,0,0,0,0,25288,16151,519238,0.0,239228,823,0.06976093468445618,46184,117,0,0,117,63158,0.02585533850322584,-30033,0,117,0,0.002878016382554793,0,10841,0,206,0,0,11047,10635,0.0031524866343501973,366589,127361,
0,0.0,0,0,0,0,25288,16151,519238,0.0,239228,823,0.06976093468445618,46184,69,0,0,69,63158,0.02585533850322584,-30033,0,69,0,0.0016928776466547265,0,10841,0,206,0,0,11047,10635,0.0031524866343501973,366589,127361,
0,0.0,0,0,0,0,25288,16151,519238,0.0,239228,823,0.06976093468445618,46184,85,0,0,85,63158,0.02585533850322584,-30033,0,85,0,0.0020792054988870135,0,10841,0,206,0,0,11047,10635,0.0031524866343501973,366589,127361,
0,0.0,0,0,0,0,25288,16151,519238,0.0,239228,823,0.06976093468445618,46184,85,0,0,85,63158,0.02585533850322584,-30033,0,85,0,0.0020730190473867765,0,10841,0,206,0,0,11047,10635,0.0031524866343501973,366589,127361,
0,0.0,0,0,0,0,25288,16151,519238,0.0,239228,823,0.06976093468445618,46184,81,0,0,81,63158,0.02585533850322584,-30033,0,81,0,0.001969796454366382,0,10841,0,206,0,0,11047,10635,0.0031524866343501973,366589,127361,
0,0.0,0,0,0,0,25288,16151,519238,0.0,239228,823,0.06976093468445618,46184,69,0,0,69,63158,0.02585533850322584,-30033,0,69,0,0.0016736604652290974,0,10841,0,206,0,0,11047,10635,0.0031524866343501973,366589,127361,
0,0.0,0,0,0,0,25288,16151,519238,0.0,239228,823,0.06976093468445618,46184,117,0,0,117,63158,0.02585533850322584,-30033,0,117,0,0.0028206364513018323,0,10841,0,206,0,0,11047,10635,0.0031524866343501973,366589,127361,
0,0.0,0,0,0,0,25288,16151,519238,0.0,239228,823,0.06976093468445618,46184,69,0,0,69,63158,0.02585533850322584,-30033,0,69,0,0.0016592122348867407,0,10841,0,206,0,0,11047,10635,0.0031524866343501973,366589,127361,
0,0.0,0,0,0,0,25288,16151,519238,0.0,239228,823,0.06976093468445618,46184,111,0,0,111,63158,0.02585533850322584,-30033,0,111,0,0.0026597019216945414,0,10841,0,206,0,0,11047,10635,0.0031524866343501973,366589,127361,
0,0.0,0,0,0,0,25288,16151,519238,0.0,239228,823,0.06976093468445618,46184,81,0,0,81,63158,0.02585533850322584,-30033,0,81,0,0.0019353913791455605,0,10841,0,206,0,0,11047,10635,0.0031524866343501973,366589,127361,
0,0.0,0,0,0,0,25288,16151,519238,0.0,239228,823,0.06976093468445618,46184,94,0,0,94,63158,0.02585533850322584,-30033,0,94,0,0.002239001500607389,0,10841,0,206,0,0,11047,10635,0.0031524866343501973,366589,127361,
0,0.0,0,0,0,0,25288,16151,519238,0.0,239228,823,0.06976093468445618,46184,81,0,0,81,63158,0.02585533850322584,-30033,0,81,0,0.0019239447994109404,0,10841,0,206,0,0,11047,10635,0.0031524866343501973,366589,127361,
0,0.0,0,0,0,0,25288,16151,519238,0.0,239228,823,0.06976093468445618,46184,81,0,0,81,63158,0.02585533850322584,-30033,0,81,0,0.0019239447994109404,0,10841,0,206,0,0,11047,10635,0.0031524866343501973,366589,127361,
0,0.0,0,0,0,0,25288,16151,519238,0.0,239228,823,0.06976093468445618,46184,81,0,0,81,63158,0.02585533850322584,-30033,0,81,0,0.0019239447994109404,0,10841,0,206,0,0,11047,10635,0.0031524866343501973,366589,127361,
0,0.0,0,0,0,0,25288,16151,519238,0.0,239228,823,0.06976093468445618,46184,81,0,0,81,63158,0.02585533850322584,-30033,0,81,0,0.0019185674696226818,0,10841,0,206,0,0,11047,10635,0.0031524866343501973,366589,127361,
0,0.0,0,0,0,0,25288,16151,519238,0.0,239228,823,0.06976093468445618,46184,81,0,0,81,63158,0.02585533850322584,-30033,0,81,0,0.0019185674696226818,0,10841,0,206,0,0,11047,10635,0.0031524866343501973,366589,127361,
0,0.0,0,0,0,0,25288,16151,519238,0.0,239228,823,0.06976093468445618,46184,81,0,0,81,63158,0.02585533850322584,-30033,0,81,0,0.0019185674696226818,0,10841,0,206,0,0,11047,10635,0.0031524866343501973,366589,127361,
0,0.0,0,0,0,0,25288,16151,519238,0.0,239228,823,0.06976093468445618,46184,131,0,0,131,63158,0.02585533850322584,-30033,0,131,0,0.003090570222002029,0,10841,0,206,0,0,11047,10635,0.0031524866343501973,366589,127361,
0,0.0,0,0,0,0,25288,16151,519238,0.0,239228,823,0.06976093468445618,46184,131,0,0,131,63158,0.02585533850322584,-30033,0,131,0,0.003090570222002029,0,10841,0,206,0,0,11047,10635,0.0031524866343501973,366589,127361,
0,0.0,0,0,0,0,25288,16151,519238,0.0,239228,823,0.06976093468445618,46184,131,0,0,131,63158,0.02585533850322584,-30033,0,131,0,0.003090570222002029,0,10841,0,206,0,0,11047,10635,0.0031524866343501973,366589,127361,
0,0.0,0,0,0,0,25288,16151,519238,0.0,239228,823,0.06976093468445618,46184,131,0,0,131,63158,0.02585533850322584,-30033,0,131,0,0.003090570222002029,0,10841,0,206,0,0,11047,10635,0.0031524866343501973,366589,127361,
0,0.0,0,0,0,0,25288,16151,519238,0.0,239228,823,0.06976093468445618,46184,131,0,0,131,63158,0.02585533850322584,-30033,0,131,0,0.003090570222002029,0,10841,0,206,0,0,11047,10635,0.0031524866343501973,366589,127361,
0,0.0,0,0,0,0,25288,16151,519238,0.0,239228,823,0.06976093468445618,46184,120,0,0,120,63158,0.02585533850322584,-30033,0,120,0,0.0028206092515983454,0,10841,0,206,0,0,11047,10635,0.0031524866343501973,366589,127361,
0,0.0,0,0,0,0,25288,16151,519238,0.0,239228,823,0.06976093468445618,46184,120,0,0,120,63158,0.02585533850322584,-30033,0,120,0,0.0028206092515983454,0,10841,0,206,0,0,11047,10635,0.0031524866343501973,366589,127361,
0,0.0,0,0,0,0,25288,16151,519238,0.0,239228,823,0.06976093468445618,46184,120,0,0,120,63158,0.02585533850322584,-30033,0,120,0,0.0028206092515983454,0,10841,0,206,0,0,11047,10635,0.0031524866343501973,366589,127361,
0,0.0,0,0,0,0,25288,16151,519238,0.0,239228,823,0.06976093468445618,46184,104,0,0,104,63158,0.02585533850322584,-30033,0,104,0,0.0024364530865643667,0,10841,0,206,0,0,11047,10635,0.0031524866343501973,366589,127361,
0,0.0,0,0,0,0,25288,16151,519238,0.0,239228,823,0.06976093468445618,46184,104,0,0,104,63158,0.02585533850322584,-30033,0,104,0,0.0024284313267641153,0,10841,0,206,0,0,11047,10635,0.0031524866343501973,366589,127361,
0,0.0,0,0,0,0,25288,16151,519238,0.0,239228,823,0.06976093468445618,46184,69,0,0,69,63158,0.02585533850322584,-30033,0,69,0,0.0016071927699618,0,10841,0,206,0,0,11047,10635,0.0031524866343501973,366589,127361,
0,0.0,0,0,0,0,25288,16151,519238,0.0,239228,823,0.06976093468445618,46184,69,0,0,69,63158,0.02585533850322584,-30033,0,69,0,0.001603234351038617,0,10841,0,206,0,0,11047,10635,0.0031524866343501973,366589,127361,
0,0.0,0,0,0,0,25288,16151,519238,0.0,239228,823,0.06976093468445618,46184,81,0,0,81,63158,0.02585533850322584,-30033,0,81,0,0.0018769116692927983,0,10841,0,206,0,0,11047,10635,0.0031524866343501973,366589,127361,
0,0.0,0,0,0,0,25288,16151,519238,0.0,239228,823,0.06976093468445618,46184,69,0,0,69,63158,0.02585533850322584,-30033,0,69,0,0.0015949331977254866,0,10841,0,206,0,0,11047,10635,0.0031524866343501973,366589,127361,
0,0.0,0,0,0,0,25288,16151,519238,0.0,239228,823,0.06976093468445618,46184,107,0,0,107,63158,0.02585533850322584,-30033,0,107,0,0.0024650969911993734,0,10841,0,206,0,0,11047,10635,0.0031524866343501973,366589,127361,
0,0.0,0,0,0,0,25288,16151,519238,0.0,239228,823,0.06976093468445618,46184,93,0,0,93,63158,0.02585533850322584,-30033,0,93,0,0.0021361631753031973,0,10841,0,206,0,0,11047,10635,0.0031524866343501973,366589,127361,
0,0.0,0,0,0,0,25288,16151,519238,0.0,239228,823,0.06976093468445618,46184,184,0,0,184,63158,0.02585533850322584,-30033,0,184,0,0.0042045610346876285,0,10841,0,206,0,0,11047,10635,0.0031524866343501973,366589,127361,
0,0.0,0,0,0,0,25288,16151,519238,0.0,239228,823,0.06976093468445618,46184,69,0,0,69,63158,0.02585533850322584,-30033,0,69,0,0.0015729005197410413,0,10841,0,206,0,0,11047,10635,0.0031524866343501973,366589,127361,
0,0.0,0,0,0,0,25288,16151,519238,0.0,239228,823,0.06976093468445618,46184,122,0,0,122,63158,0.02585533850322584,-30033,0,122,0,0.002770963932043245,0,10841,0,206,0,0,11047,10635,0.0031524866343501973,366589,127361,
0,0.0,0,0,0,0,25288,16151,519238,0.0,239228,823,0.06976093468445618,46184,69,0,0,69,63158,0.02585533850322584,-30033,0,69,0,0.001563420492137581,0,10841,0,206,0,0,11047,10635,0.0031524866343501973,366589,127361,
0,0.0,0,0,0,0,25288,16151,519238,0.0,239228,823,0.06976093468445618,46184,97,0,0,97,63158,0.02585533850322584,-30033,0,97,0,0.002191199060269269,0,10841,0,206,0,0,11047,10635,0.0031524866343501973,366589,127361,
0,0.0,0,0,0,0,25288,16151,519238,0.0,239228,823,0.06976093468445618,46184,98,0,0,98,63158,0.02585533850322584,-30033,0,98,0,0.0022070580816611492,0,10841,0,206,0,0,11047,10635,0.0031524866343501973,366589,127361,
0,0.0,0,0,0,0,25288,16151,519238,0.0,239228,823,0.06976093468445618,46184,81,0,0,81,63158,0.02585533850322584,-30033,0,81,0,0.0018193661418207138,0,10841,0,206,0,0,11047,10635,0.0031524866343501973,366589,127361,
0,0.0,0,0,0,0,25288,16151,519238,0.0,239228,823,0.06976093468445618,46184,159,0,0,159,63158,0.02585533850322584,-30033,0,159,0,0.0035554561717352413,0,10841,0,206,0,0,11047,10635,0.0031524866343501973,366589,127361,
0,0.0,0,0,0,0,25288,16151,519238,0.0,239228,823,0.06976093468445618,46184,81,0,0,81,63158,0.02585533850322584,-30033,0,81,0,0.0018065034122842231,0,10841,0,206,0,0,11047,10635,0.0031524866343501973,366589,127361,
0,0.0,0,0,0,0,25288,16151,519238,0.0,239228,823,0.06976093468445618,46184,149,0,0,149,63158,0.02585533850322584,-30033,0,149,0,0.003309272626318712,0,10841,0,206,0,0,11047,10635,0.0031524866343501973,366589,127361,
0,0.0,0,0,0,0,25288,16151,519238,0.0,239228,823,0.06976093468445618,46184,93,0,0,93,63158,0.02585533850322584,-30033,0,93,0,0.002059572583324106,0,10841,0,206,0,0,11047,10635,0.0031524866343501973,366589,127361,
0,0.0,0,0,0,0,25288,16151,519238,0.0,239228,823,0.06976093468445618,46184,80,0,0,80,63158,0.02585533850322584,-30033,0,80,0,0.0017670966601873123,0,10841,0,206,0,0,11047,10635,0.0031524866343501973,366589,127361,
0,0.0,0,0,0,0,25288,16151,519238,0.0,239228,823,0.06976093468445618,46184,148,0,0,148,63158,0.02585533850322584,-30033,0,148,0,0.00325568094326756,0,10841,0,206,0,0,11047,10635,0.0031524866343501973,366589,127361,
0,0.0,0,0,0,0,25288,16151,519238,0.0,239228,823,0.06976093468445618,46184,109,0,0,109,63158,0.02585533850322584,-30033,0,109,0,0.002390088806051968,0,10841,0,206,0,0,11047,10635,0.0031524866343501973,366589,127361,
0,0.0,0,0,0,0,25288,16151,519238,0.0,239228,823,0.06976093468445618,46184,69,0,0,69,63158,0.02585533850322584,-30033,0,69,0,0.0015094834941261402,0,10841,0,206,0,0,11047,10635,0.0031524866343501973,366589,127361,
0,0.0,0,0,0,0,25288,16151,519238,0.0,239228,823,0.06976093468445618,46184,97,0,0,97,63158,0.02585533850322584,-30033,0,97,0,0.0021158250627113097,0,10841,0,206,0,0,11047,10635,0.0031524866343501973,366589,127361,
0,0.0,0,0,0,0,25288,16151,519238,0.0,239228,823,0.06976093468445618,46184,119,0,0,119,63158,0.02585533850322584,-30033,0,119,0,0.0025869002847764178,0,10841,0,206,0,0,11047,10635,0.0031524866343501973,366589,127361,
0,0.0,0,0,0,0,25288,16151,519238,0.0,239228,823,0.06976093468445618,46184,69,0,0,69,63158,0.02585533850322584,-30033,0,69,0,0.0014965189667512525,0,10841,0,206,0,0,11047,10635,0.0031524866343501973,366589,127361,
0,0.0,0,0,0,0,25288,16151,519238,0.0,239228,823,0.06976093468445618,46184,113,76,0,189,63158,0.02585533850322584,-30033,0,37,0,0.0109182448155065,0,10841,0,206,0,0,11047,10635,0.0031524866343501973,366589,127361,
0,0.0,0,0,0,0,25288,16151,519238,0.0,239228,823,0.06976093468445618,46184,113,76,0,189,63158,0.02585533850322584,-30033,0,37,0,0.0109182448155065,0,10841,0,206,0,0,11047,10635,0.0031524866343501973,366589,127361,
0,0.0,0,0,0,0,25288,16151,519238,0.0,239228,823,0.06976093468445618,46184,149,0,0,149,63158,0.02585533850322584,-30033,0,149,0,0.003120353500450252,0,10841,0,206,0,0,11047,10635,0.0031524866343501973,366589,127361,
0,0.0,0,0,0,0,25288,16151,519238,0.0,239228,823,0.06976093468445618,46184,69,0,0,69,63158,0.02585533850322584,-30033,0,69,0,0.0014417953486428317,0,10841,0,206,0,0,11047,10635,0.0031524866343501973,366589,127361,
0,0.0,0,0,0,0,25288,16151,519238,0.0,239228,823,0.06976093468445618,46184,171,0,0,171,63158,0.02585533850322584,-30033,0,171,0,0.0035573122529644267,0,10841,0,206,0,0,11047,10635,0.0031524866343501973,366589,127361,
0,0.0,0,0,0,0,25288,16151,519238,0.0,239228,823,0.06976093468445618,46184,105,0,0,105,63158,0.02585533850322584,-30033,0,105,0,0.0021778810254708372,0,10841,0,206,0,0,11047,10635,0.0031524866343501973,366589,127361,
0,0.0,0,0,0,0,25288,16151,519238,0.0,239228,823,0.06976093468445618,46184,134,0,0,134,63158,0.02585533850322584,-30033,0,134,0,0.0027694533429781956,0,10841,0,206,0,0,11047,10635,0.0031524866343501973,366589,127361,
0,0.0,0,0,0,0,25288,16151,519238,0.0,239228,823,0.06976093468445618,46184,80,0,0,80,63158,0.02585533850322584,-30033,0,80,0,0.0016494165189064368,0,10841,0,206,0,0,11047,10635,0.0031524866343501973,366589,127361,
0,0.0,0,0,0,0,25288,16151,519238,0.0,239228,823,0.06976093468445618,46184,110,0,0,110,63158,0.02585533850322584,-30033,0,110,0,0.0022610947809821374,0,10841,0,206,0,0,11047,10635,0.0031524866343501973,366589,127361,
0,0.0,0,0,0,0,25288,16151,519238,0.0,239228,823,0.06976093468445618,46184,80,0,0,80,63158,0.02585533850322584,-30033,0,80,0,0.0016404872247057377,0,10841,0,206,0,0,11047,10635,0.0031524866343501973,366589,127361,
0,0.0,0,0,0,0,25288,16151,519238,0.0,239228,823,0.06976093468445618,46184,98,0,0,98,63158,0.02585533850322584,-30033,0,98,0,0.002,0,10841,0,206,0,0,11047,10635,0.0031524866343501973,366589,127361,
0,0.0,0,0,0,0,25288,16151,519238,0.0,239228,823,0.06976093468445618,46184,81,0,0,81,63158,0.02585533850322584,-30033,0,81,0,0.0016490899466590659,0,10841,0,206,0,0,11047,10635,0.0031524866343501973,366589,127361,
0,0.0,0,0,0,0,25288,16151,519238,0.0,239228,823,0.06976093468445618,46184,147,0,0,147,63158,0.02585533850322584,-30033,0,147,0,0.0029815025150089244,0,10841,0,206,0,0,11047,10635,0.0031524866343501973,366589,127361,
0,0.0,0,0,0,0,25288,16151,519238,0.0,239228,823,0.06976093468445618,46184,81,0,0,81,63158,0.02585533850322584,-30033,0,81,0,0.0016389462182833556,0,10841,0,206,0,0,11047,10635,0.0031524866343501973,366589,127361,
0,0.0,0,0,0,0,25288,16151,519238,0.0,239228,823,0.06976093468445618,46184,119,0,0,119,63158,0.02585533850322584,-30033,0,119,0,0.002400258179031022,0,10841,0,206,0,0,11047,10635,0.0031524866343501973,366589,127361,
0,0.0,0,0,0,0,25288,16151,519238,0.0,239228,823,0.06976093468445618,46184,135,0,0,135,63158,0.02585533850322584,-30033,0,135,0,0.0027135132962151517,0,10841,0,206,0,0,11047,10635,0.0031524866343501973,366589,127361,
0,0.0,0,0,0,0,25288,16151,519238,0.0,239228,823,0.06976093468445618,46184,121,0,0,121,63158,0.02585533850322584,-30033,0,121,0,0.0024244124306237354,0,10841,0,206,0,0,11047,10635,0.0031524866343501973,366589,127361,
0,0.0,0,0,0,0,25288,16151,519238,0.0,239228,823,0.06976093468445618,46184,69,0,0,69,63158,0.02585533850322584,-30033,0,69,0,0.0013795861241627512,0,10841,0,206,0,0,11047,10635,0.0031524866343501973,366589,127361,
0,0.0,0,0,0,0,25288,16151,519238,0.0,239228,823,0.06976093468445618,46184,119,0,0,119,63158,0.02585533850322584,-30033,0,119,0,0.0023718881425524706,0,10841,0,206,0,0,11047,10635,0.0031524866343501973,366589,127361,
0,0.0,0,0,0,0,25288,16151,519238,0.0,239228,823,0.06976093468445618,46184,69,0,0,69,63158,0.02585533850322584,-30033,0,69,0,0.0013723969210573423,0,10841,0,206,0,0,11047,10635,0.0031524866343501973,366589,127361,
0,0.0,0,0,0,0,25288,16151,519238,0.0,239228,823,0.06976093468445618,46184,80,0,0,80,63158,0.02585533850322584,-30033,0,80,0,0.0015874905742747152,0,10841,0,206,0,0,11047,10635,0.0031524866343501973,366589,127361,
0,0.0,0,0,0,0,25288,16151,519238,0.0,239228,823,0.06976093468445618,46184,128,0,0,128,63158,0.02585533850322584,-30033,0,128,0,0.0025316956427144524,0,10841,0,206,0,0,11047,10635,0.0031524866343501973,366589,127361,
0,0.0,0,0,0,0,25288,16151,519238,0.0,239228,823,0.06976093468445618,46184,80,0,0,80,63158,0.02585533850322584,-30033,0,80,0,0.0015786565632646618,0,10841,0,206,0,0,11047,10635,0.0031524866343501973,366589,127361,
0,0.0,0,0,0,0,25288,16151,519238,0.0,239228,823,0.06976093468445618,46184,106,0,0,106,63158,0.02585533850322584,-30033,0,106,0,0.002085834038450186,0,10841,0,206,0,0,11047,10635,0.0031524866343501973,366589,127361,
0,0.0,0,0,0,0,25288,16151,519238,0.0,239228,823,0.06976093468445618,46184,106,0,0,106,63158,0.02585533850322584,-30033,0,106,0,0.002085834038450186,0,10841,0,206,0,0,11047,10635,0.0031524866343501973,366589,127361,
0,0.0,0,0,0,0,25288,16151,519238,0.0,239228,823,0.06976093468445618,46184,106,0,0,106,63158,0.02585533850322584,-30033,0,106,0,0.002085834038450186,0,10841,0,206,0,0,11047,10635,0.0031524866343501973,366589,127361,
0,0.0,0,0,0,0,25288,16151,519238,0.0,239228,823,0.06976093468445618,46184,81,0,0,81,63158,0.02585533850322584,-30033,0,81,0,0.0015901996584015549,0,10841,0,206,0,0,11047,10635,0.0031524866343501973,366589,127361,
0,0.0,0,0,0,0,25288,16151,519238,0.0,239228,823,0.06976093468445618,46184,81,0,0,81,63158,0.02585533850322584,-30033,0,81,0,0.0015901996584015549,0,10841,0,206,0,0,11047,10635,0.0031524866343501973,366589,127361,
0,0.0,0,0,0,0,25288,16151,519238,0.0,239228,823,0.06976093468445618,46184,81,0,0,81,63158,0.02585533850322584,-30033,0,81,0,0.0015901996584015549,0,10841,0,206,0,0,11047,10635,0.0031524866343501973,366589,127361,
0,0.0,0,0,0,0,25288,16151,519238,0.0,239228,823,0.06976093468445618,46184,105,0,0,105,63158,0.02585533850322584,-30033,0,105,0,0.002055639303823489,0,10841,0,206,0,0,11047,10635,0.0031524866343501973,366589,127361,
0,0.0,0,0,0,0,25288,16151,519238,0.0,239228,823,0.06976093468445618,46184,93,0,0,93,63158,0.02585533850322584,-30033,0,93,0,0.0018160870159542267,0,10841,0,206,0,0,11047,10635,0.0031524866343501973,366589,127361,
0,0.0,0,0,0,0,25288,16151,519238,0.0,239228,823,0.06976093468445618,46184,93,0,0,93,63158,0.02585533850322584,-30033,0,93,0,0.0018160870159542267,0,10841,0,206,0,0,11047,10635,0.0031524866343501973,366589,127361,
0,0.0,0,0,0,0,25288,16151,519238,0.0,239228,823,0.06976093468445618,46184,93,0,0,93,63158,0.02585533850322584,-30033,0,93,0,0.0018160870159542267,0,10841,0,206,0,0,11047,10635,0.0031524866343501973,366589,127361,
0,0.0,0,0,0,0,25288,16151,519238,0.0,239228,823,0.06976093468445618,46184,81,0,0,81,63158,0.02585533850322584,-30033,0,81,0,0.0015781167806417674,0,10841,0,206,0,0,11047,10635,0.0031524866343501973,366589,127361,
0,0.0,0,0,0,0,25288,16151,519238,0.0,239228,823,0.06976093468445618,46184,69,0,0,69,63158,0.02585533850322584,-30033,0,69,0,0.0013415511442070266,0,10841,0,206,0,0,11047,10635,0.0031524866343501973,366589,127361,
0,0.0,0,0,0,0,25288,16151,519238,0.0,239228,823,0.06976093468445618,46184,69,0,0,69,63158,0.02585533850322584,-30033,0,69,0,0.0013387919827703293,0,10841,0,206,0,0,11047,10635,0.0031524866343501973,366589,127361,
0,0.0,0,0,0,0,25288,16151,519238,0.0,239228,823,0.06976093468445618,46184,69,0,0,69,63158,0.02585533850322584,-30033,0,69,0,0.001336044147545745,0,10841,0,206,0,0,11047,10635,0.0031524866343501973,366589,127361,
0,0.0,0,0,0,0,25288,16151,519238,0.0,239228,823,0.06976093468445618,46184,69,0,0,69,63158,0.02585533850322584,-30033,0,69,0,0.001333307568935866,0,10841,0,206,0,0,11047,10635,0.0031524866343501973,366589,127361,
0,0.0,0,0,0,0,25288,16151,519238,0.0,239228,823,0.06976093468445618,46184,69,0,0,69,63158,0.02585533850322584,-30033,0,69,0,0.0013305821779123358,0,10841,0,206,0,0,11047,10635,0.0031524866343501973,366589,127361,
0,0.0,0,0,0,0,25288,16151,519238,0.0,239228,823,0.06976093468445618,46184,69,0,0,69,63158,0.02585533850322584,-30033,0,69,0,0.0013278679060100456,0,10841,0,206,0,0,11047,10635,0.0031524866343501973,366589,127361,
2,0.0,0,2,0,4,25288,16151,519238,0.0010048464943023653,239228,823,0.06976093468445618,46184,518,32,3,553,63158,0.02585533850322584,-30033,0,486,0,0.030742260302365845,0,1180,0,121,17,0,1318,1059,0.007947314708307823,366589,127361,
0,0.0,0,0,0,0,25288,16151,519238,0.0,239228,823,0.06976093468445618,46184,225,39,1,265,63158,0.02585533850322584,-30033,0,186,0,0.08847045164912352,0,729,0,73,25,0,827,656,0.06732232698750938,366589,127361,
0,0.0,0,0,0,0,25288,16151,519238,0.0,239228,823,0.06976093468445618,46184,225,39,1,265,63158,0.02585533850322584,-30033,0,186,0,0.08847045164912352,0,729,0,73,25,0,827,656,0.06732232698750938,366589,127361,
5,0.0024271844660194173,0,10,-5,15,25288,16151,519238,0.03805883657691644,239228,823,0.06976093468445618,46184,557,32,6,595,63158,0.02585533850322584,-30033,1,525,1,0.11068830784217279,2,1442,0,57,6,0,1505,1385,0.11561614322544184,366589,127361,
5,0.0024271844660194173,0,10,-5,15,25288,16151,519238,0.03805883657691644,239228,823,0.06976093468445618,46184,557,32,6,595,63158,0.02585533850322584,-30033,1,525,1,0.11068830784217279,2,1442,0,57,6,0,1505,1385,0.11561614322544184,366589,127361,
5,0.0024271844660194173,0,10,-5,15,25288,16151,519238,0.03805883657691644,239228,823,0.06976093468445618,46184,557,32,6,595,63158,0.02585533850322584,-30033,1,525,1,0.11068830784217279,2,1442,0,57,6,0,1505,1385,0.11561614322544184,366589,127361,
5,0.0,0,10,-5,15,25288,16151,519238,0.03805883657691644,239228,823,0.06976093468445618,46184,1,16,0,17,63158,0.02585533850322584,-30033,0,-15,0,0.21408730158730158,0,1442,0,57,6,0,1505,1385,0.11561614322544184,366589,127361,
5,0.0,0,10,-5,15,25288,16151,519238,0.03805883657691644,239228,823,0.06976093468445618,46184,1,16,0,17,63158,0.02585533850322584,-30033,0,-15,0,0.21408730158730158,0,1442,0,57,6,0,1505,1385,0.11561614322544184,366589,127361,
5,0.0,0,10,-5,15,25288,16151,519238,0.03805883657691644,239228,823,0.06976093468445618,46184,1,16,0,17,63158,0.02585533850322584,-30033,0,-15,0,0.21408730158730158,0,1442,0,57,6,0,1505,1385,0.11561614322544184,366589,127361,
5,0.0,0,10,-5,15,25288,16151,519238,0.03805883657691644,239228,823,0.06976093468445618,46184,1,16,0,17,63158,0.02585533850322584,-30033,0,-15,0,0.21408730158730158,0,1442,0,57,6,0,1505,1385,0.11561614322544184,366589,127361,
5,0.0,0,10,-5,15,25288,16151,519238,0.03805883657691644,239228,823,0.06976093468445618,46184,1,16,0,17,63158,0.02585533850322584,-30033,0,-15,0,0.21408730158730158,0,1442,0,57,6,0,1505,1385,0.11561614322544184,366589,127361,
0,0.0,0,0,0,0,25288,16151,519238,0.0,239228,823,0.06976093468445618,46184,221,16,11,248,63158,0.02585533850322584,-30033,0,205,0,0.3997302204928664,0,221,0,16,11,0,248,205,0.3997302204928664,366589,127361,
0,0.0,0,0,0,0,25288,16151,519238,0.0,239228,823,0.06976093468445618,46184,359,2,0,361,63158,0.02585533850322584,-30033,0,357,0,0.33455382152861146,0,780,0,113,0,0,893,667,0.08769833977133294,366589,127361,
0,0.0,0,0,0,0,25288,16151,519238,0.0,239228,823,0.06976093468445618,46184,174,102,0,276,63158,0.02585533850322584,-30033,0,72,0,0.2915653890397516,0,780,0,113,0,0,893,667,0.08769833977133294,366589,127361,
0,0.0,0,0,0,0,25288,16151,519238,0.0,239228,823,0.06976093468445618,46184,174,102,0,276,63158,0.02585533850322584,-30033,0,72,0,0.2915653890397516,0,780,0,113,0,0,893,667,0.08769833977133294,366589,127361,
0,0.0,0,0,0,0,25288,16151,519238,0.0,239228,823,0.06976093468445618,46184,3,0,0,3,63158,0.02585533850322584,-30033,0,3,0,4.3047783039173483E-4,0,780,0,113,0,0,893,667,0.08769833977133294,366589,127361,
0,0.0,0,0,0,0,25288,16151,519238,0.0,239228,823,0.06976093468445618,46184,141,10,8,159,63158,0.02585533850322584,-30033,0,131,0,0.008537314472416992,0,220,0,10,8,0,238,210,0.00672678338156912,366589,127361,
5,0.0,0,14,-9,19,25288,16151,519238,0.016379310344827588,239228,823,0.06976093468445618,46184,0,0,0,0,63158,0.02585533850322584,-30033,0,0,0,0.0,0,223,0,39,6,0,268,184,0.013684181936678511,366589,127361,
5,0.0,0,14,-9,19,25288,16151,519238,0.016379310344827588,239228,823,0.06976093468445618,46184,0,0,0,0,63158,0.02585533850322584,-30033,0,0,0,0.0,0,223,0,39,6,0,268,184,0.013684181936678511,366589,127361,
5,0.0,0,14,-9,19,25288,16151,519238,0.016379310344827588,239228,823,0.06976093468445618,46184,0,0,0,0,63158,0.02585533850322584,-30033,0,0,0,0.0,0,223,0,39,6,0,268,184,0.013684181936678511,366589,127361,
1,5.047955577990914E-4,0,0,1,1,25288,16151,519238,5.047955577990914E-4,239228,823,0.06976093468445618,46184,21,9,0,30,63158,0.02585533850322584,-30033,0,12,1,0.20916952650917578,1,21,0,9,0,1,30,12,0.20916952650917578,366589,127361,
4,0.0,0,109,-105,113,25288,16151,519238,0.0012143886833838342,239228,823,0.06976093468445618,46184,179,3,0,182,63158,0.02585533850322584,-30033,0,176,0,0.11271826067365101,0,6319,0,313,28,0,6660,6006,0.046866952231328515,366589,127361,
4,0.0,0,109,-105,113,25288,16151,519238,0.0012143886833838342,239228,823,0.06976093468445618,46184,392,0,0,392,63158,0.02585533850322584,-30033,0,392,0,0.08705307572729291,0,6319,0,313,28,0,6660,6006,0.046866952231328515,366589,127361,
4,0.0,0,109,-105,113,25288,16151,519238,0.0012143886833838342,239228,823,0.06976093468445618,46184,392,0,0,392,63158,0.02585533850322584,-30033,0,392,0,0.08705307572729291,0,6319,0,313,28,0,6660,6006,0.046866952231328515,366589,127361,
4,0.0,0,109,-105,113,25288,16151,519238,0.0012143886833838342,239228,823,0.06976093468445618,46184,392,0,0,392,63158,0.02585533850322584,-30033,0,392,0,0.08705307572729291,0,6319,0,313,28,0,6660,6006,0.046866952231328515,366589,127361,
4,0.0,0,109,-105,113,25288,16151,519238,0.0012143886833838342,239228,823,0.06976093468445618,46184,392,0,0,392,63158,0.02585533850322584,-30033,0,392,0,0.08705307572729291,0,6319,0,313,28,0,6660,6006,0.046866952231328515,366589,127361,
4,0.0,0,109,-105,113,25288,16151,519238,0.0012143886833838342,239228,823,0.06976093468445618,46184,389,0,0,389,63158,0.02585533850322584,-30033,0,389,0,0.046839253461770015,0,6319,0,313,28,0,6660,6006,0.046866952231328515,366589,127361,
4,0.0,0,109,-105,113,25288,16151,519238,0.0012143886833838342,239228,823,0.06976093468445618,46184,389,0,0,389,63158,0.02585533850322584,-30033,0,389,0,0.046839253461770015,0,6319,0,313,28,0,6660,6006,0.046866952231328515,366589,127361,
4,0.0,0,109,-105,113,25288,16151,519238,0.0012143886833838342,239228,823,0.06976093468445618,46184,1,1,0,2,63158,0.02585533850322584,-30033,0,0,0,0.13333333333333333,0,6319,0,313,28,0,6660,6006,0.046866952231328515,366589,127361,
4,0.0,0,109,-105,113,25288,16151,519238,0.0012143886833838342,239228,823,0.06976093468445618,46184,769,2,0,771,63158,0.02585533850322584,-30033,0,767,0,0.041121182515559414,0,6319,0,313,28,0,6660,6006,0.046866952231328515,366589,127361,
4,0.0,0,109,-105,113,25288,16151,519238,0.0012143886833838342,239228,823,0.06976093468445618,46184,769,2,0,771,63158,0.02585533850322584,-30033,0,767,0,0.041121182515559414,0,6319,0,313,28,0,6660,6006,0.046866952231328515,366589,127361,
4,0.0,0,109,-105,113,25288,16151,519238,0.0012143886833838342,239228,823,0.06976093468445618,46184,351,0,0,351,63158,0.02585533850322584,-30033,0,351,0,0.025217328831094187,0,6319,0,313,28,0,6660,6006,0.046866952231328515,366589,127361,
4,0.0,0,109,-105,113,25288,16151,519238,0.0012143886833838342,239228,823,0.06976093468445618,46184,351,0,0,351,63158,0.02585533850322584,-30033,0,351,0,0.025217328831094187,0,6319,0,313,28,0,6660,6006,0.046866952231328515,366589,127361,
4,0.0,0,109,-105,113,25288,16151,519238,0.0012143886833838342,239228,823,0.06976093468445618,46184,351,0,0,351,63158,0.02585533850322584,-30033,0,351,0,0.025217328831094187,0,6319,0,313,28,0,6660,6006,0.046866952231328515,366589,127361,
4,0.0016647386898438626,0,109,-105,113,25288,16151,519238,0.0012143886833838342,239228,823,0.06976093468445618,46184,1,38,0,39,63158,0.02585533850322584,-30033,38,-37,1,0.0016647386898438626,39,6319,0,313,28,-37,6660,6006,0.046866952231328515,366589,127361,
4,0.0,0,109,-105,113,25288,16151,519238,0.0012143886833838342,239228,823,0.06976093468445618,46184,703,66,12,781,63158,0.02585533850322584,-30033,0,637,0,0.1202030298897126,0,6319,0,313,28,0,6660,6006,0.046866952231328515,366589,127361,
4,0.0,0,109,-105,113,25288,16151,519238,0.0012143886833838342,239228,823,0.06976093468445618,46184,703,66,12,781,63158,0.02585533850322584,-30033,0,637,0,0.1202030298897126,0,6319,0,313,28,0,6660,6006,0.046866952231328515,366589,127361,
4,0.0,0,109,-105,113,25288,16151,519238,0.0012143886833838342,239228,823,0.06976093468445618,46184,703,66,12,781,63158,0.02585533850322584,-30033,0,637,0,0.1202030298897126,0,6319,0,313,28,0,6660,6006,0.046866952231328515,366589,127361,
4,0.0,0,109,-105,113,25288,16151,519238,0.0012143886833838342,239228,823,0.06976093468445618,46184,138,20,0,158,63158,0.02585533850322584,-30033,0,118,0,0.01551153702916611,0,6319,0,313,28,0,6660,6006,0.046866952231328515,366589,127361,
4,0.0,0,109,-105,113,25288,16151,519238,0.0012143886833838342,239228,823,0.06976093468445618,46184,138,20,0,158,63158,0.02585533850322584,-30033,0,118,0,0.01551153702916611,0,6319,0,313,28,0,6660,6006,0.046866952231328515,366589,127361,
4,0.0,0,109,-105,113,25288,16151,519238,0.0012143886833838342,239228,823,0.06976093468445618,46184,138,20,0,158,63158,0.02585533850322584,-30033,0,118,0,0.01551153702916611,0,6319,0,313,28,0,6660,6006,0.046866952231328515,366589,127361,
1031,0.037037037037037035,58,1128,-97,2217,25288,16151,519238,0.0554864719791916,239228,823,0.06976093468445618,46184,206,26,4,236,63158,0.02585533850322584,-30033,0,180,4,0.06572035833232161,4,18991,0,5988,2458,4,27437,13003,0.09806308064906054,366589,127361,
1031,0.008156860224728729,58,1128,-97,2217,25288,16151,519238,0.0554864719791916,239228,823,0.06976093468445618,46184,205,43,35,283,63158,0.02585533850322584,-30033,2,162,3,0.07457089600247926,5,18991,0,5988,2458,1,27437,13003,0.09806308064906054,366589,127361,
0,0.0,0,0,0,0,25288,16151,519238,0.0,239228,823,0.06976093468445618,46184,45,0,0,45,63158,0.02585533850322584,-30033,0,45,0,0.05005561735261402,0,204,0,0,0,0,204,204,0.11845032886568271,366589,127361,
0,0.0,0,0,0,0,25288,16151,519238,0.0,239228,823,0.06976093468445618,46184,19,0,0,19,63158,0.02585533850322584,-30033,0,19,0,0.06810035842293907,0,204,0,0,0,0,204,204,0.11845032886568271,366589,127361,
0,0.0,0,0,0,0,25288,16151,519238,0.0,239228,823,0.06976093468445618,46184,55,0,0,55,63158,0.02585533850322584,-30033,0,55,0,0.0030864197530864196,0,204,0,0,0,0,204,204,0.11845032886568271,366589,127361,
0,0.0,0,0,0,0,25288,16151,519238,0.0,239228,823,0.06976093468445618,46184,45,0,0,45,63158,0.02585533850322584,-30033,0,45,0,0.46875,0,204,0,0,0,0,204,204,0.11845032886568271,366589,127361,
68,0.04004449388209121,2,307,-239,377,25288,16151,519238,0.0225204745596456,239228,823,0.06976093468445618,46184,789,123,20,932,63158,0.02585533850322584,-30033,25,666,9,0.14525660323888973,36,6286,2,1953,218,-16,8457,4333,0.0966488933647324,366589,127361,
68,0.038291605301914576,2,307,-239,377,25288,16151,519238,0.0225204745596456,239228,823,0.06976093468445618,46184,474,168,23,665,63158,0.02585533850322584,-30033,1,306,1,0.16439419270210298,2,6286,0,1953,218,0,8457,4333,0.0966488933647324,366589,127361,
68,0.0012787723785166241,2,307,-239,377,25288,16151,519238,0.0225204745596456,239228,823,0.06976093468445618,46184,389,180,17,586,63158,0.02585533850322584,-30033,3,209,3,0.041857818933430845,6,6286,0,1953,218,0,8457,4333,0.0966488933647324,366589,127361,
68,0.0012787723785166241,2,307,-239,377,25288,16151,519238,0.0225204745596456,239228,823,0.06976093468445618,46184,389,180,17,586,63158,0.02585533850322584,-30033,3,209,3,0.041857818933430845,6,6286,0,1953,218,0,8457,4333,0.0966488933647324,366589,127361,
68,0.0012787723785166241,2,307,-239,377,25288,16151,519238,0.0225204745596456,239228,823,0.06976093468445618,46184,389,180,17,586,63158,0.02585533850322584,-30033,3,209,3,0.041857818933430845,6,6286,0,1953,218,0,8457,4333,0.0966488933647324,366589,127361,
68,0.0012787723785166241,2,307,-239,377,25288,16151,519238,0.0225204745596456,239228,823,0.06976093468445618,46184,389,180,17,586,63158,0.02585533850322584,-30033,3,209,3,0.041857818933430845,6,6286,0,1953,218,0,8457,4333,0.0966488933647324,366589,127361,
68,0.0012787723785166241,2,307,-239,377,25288,16151,519238,0.0225204745596456,239228,823,0.06976093468445618,46184,389,180,17,586,63158,0.02585533850322584,-30033,3,209,3,0.041857818933430845,6,6286,0,1953,218,0,8457,4333,0.0966488933647324,366589,127361,
68,0.15452921663689717,2,307,-239,377,25288,16151,519238,0.0225204745596456,239228,823,0.06976093468445618,46184,123,156,0,279,63158,0.02585533850322584,-30033,142,-33,6,0.19317573430030227,148,6286,0,1953,218,-136,8457,4333,0.0966488933647324,366589,127361,
68,0.15452921663689717,2,307,-239,377,25288,16151,519238,0.0225204745596456,239228,823,0.06976093468445618,46184,123,156,0,279,63158,0.02585533850322584,-30033,142,-33,6,0.19317573430030227,148,6286,0,1953,218,-136,8457,4333,0.0966488933647324,366589,127361,
68,0.0,2,307,-239,377,25288,16151,519238,0.0225204745596456,239228,823,0.06976093468445618,46184,37,0,0,37,63158,0.02585533850322584,-30033,0,37,0,0.06571936056838366,0,6286,0,1953,218,0,8457,4333,0.0966488933647324,366589,127361,
68,0.006677335023801728,2,307,-239,377,25288,16151,519238,0.0225204745596456,239228,823,0.06976093468445618,46184,3129,772,155,4056,63158,0.02585533850322584,-30033,3,2357,48,0.1707961478573046,51,6286,0,1953,218,45,8457,4333,0.0966488933647324,366589,127361,
68,2.6021337496747333E-4,2,307,-239,377,25288,16151,519238,0.0225204745596456,239228,823,0.06976093468445618,46184,372,338,0,710,63158,0.02585533850322584,-30033,1,34,1,0.042589441273526596,2,6286,0,1953,218,0,8457,4333,0.0966488933647324,366589,127361,
68,2.6021337496747333E-4,2,307,-239,377,25288,16151,519238,0.0225204745596456,239228,823,0.06976093468445618,46184,372,338,0,710,63158,0.02585533850322584,-30033,1,34,1,0.042589441273526596,2,6286,0,1953,218,0,8457,4333,0.0966488933647324,366589,127361,
68,0.006643583557912822,2,307,-239,377,25288,16151,519238,0.0225204745596456,239228,823,0.06976093468445618,46184,215,141,0,356,63158,0.02585533850322584,-30033,132,74,0,0.08274825666025802,132,6286,0,1953,218,-132,8457,4333,0.0966488933647324,366589,127361,
68,0.0,2,307,-239,377,25288,16151,519238,0.0225204745596456,239228,823,0.06976093468445618,46184,301,57,0,358,63158,0.02585533850322584,-30033,0,244,0,0.045169222318924354,0,6286,0,1953,218,0,8457,4333,0.0966488933647324,366589,127361,
2,0.07052341597796144,0,8,-6,10,25288,16151,519238,0.03526170798898072,239228,823,0.06976093468445618,46184,56,102,16,174,63158,0.02585533850322584,-30033,8,-46,2,0.1539981861778162,10,93,0,336,21,-6,450,-243,0.14020075764366108,366589,127361,
2,0.07052341597796144,0,8,-6,10,25288,16151,519238,0.03526170798898072,239228,823,0.06976093468445618,46184,56,102,16,174,63158,0.02585533850322584,-30033,8,-46,2,0.1539981861778162,10,93,0,336,21,-6,450,-243,0.14020075764366108,366589,127361,
6,0.0,0,6,0,12,25288,16151,519238,6.090133982947625E-4,239228,823,0.06976093468445618,46184,6,3,0,9,63158,0.02585533850322584,-30033,0,3,0,7.73429095983965E-4,0,314,0,64,2,0,380,250,0.0034013785240251796,366589,127361,
37,0.009013520280420632,0,35,2,72,25288,16151,519238,0.0049700759034685855,239228,823,0.06976093468445618,46184,867,91,0,958,63158,0.02585533850322584,-30033,27,776,27,0.04410471297130506,54,2180,0,261,62,0,2503,1919,0.03611708176806603,366589,127361,
37,0.009013520280420632,0,35,2,72,25288,16151,519238,0.0049700759034685855,239228,823,0.06976093468445618,46184,867,91,0,958,63158,0.02585533850322584,-30033,27,776,27,0.04410471297130506,54,2180,0,261,62,0,2503,1919,0.03611708176806603,366589,127361,
37,0.009013520280420632,0,35,2,72,25288,16151,519238,0.0049700759034685855,239228,823,0.06976093468445618,46184,867,91,0,958,63158,0.02585533850322584,-30033,27,776,27,0.04410471297130506,54,2180,0,261,62,0,2503,1919,0.03611708176806603,366589,127361,
0,0.0,0,0,0,0,25288,16151,519238,0.0,239228,823,0.06976093468445618,46184,271,24,8,303,63158,0.02585533850322584,-30033,0,247,0,0.00873588518215662,0,1301,0,369,17,0,1687,932,0.06334934011772417,366589,127361,
0,0.0,0,0,0,0,25288,16151,519238,0.0,239228,823,0.06976093468445618,46184,271,24,8,303,63158,0.02585533850322584,-30033,0,247,0,0.00873588518215662,0,1301,0,369,17,0,1687,932,0.06334934011772417,366589,127361,
0,0.0,0,0,0,0,25288,16151,519238,0.0,239228,823,0.06976093468445618,46184,271,24,8,303,63158,0.02585533850322584,-30033,0,247,0,0.00873588518215662,0,1301,0,369,17,0,1687,932,0.06334934011772417,366589,127361,
0,0.0,0,0,0,0,25288,16151,519238,0.0,239228,823,0.06976093468445618,46184,271,24,8,303,63158,0.02585533850322584,-30033,0,247,0,0.00873588518215662,0,1301,0,369,17,0,1687,932,0.06334934011772417,366589,127361,
75,0.16184196901075304,0,13,62,88,25288,16151,519238,0.16154104973591749,239228,823,0.06976093468445618,46184,101,11,5,117,63158,0.02585533850322584,-30033,3,90,39,0.06652254074420223,42,222,0,21,5,36,248,201,0.19977132359499064,366589,127361,
23,0.17702172099434155,0,234,-211,257,25288,16151,519238,0.04185914358140774,239228,823,0.06976093468445618,46184,1458,514,98,2070,63158,0.02585533850322584,-30033,11,944,9,0.11083802918079518,20,7017,0,4701,607,-2,12325,2316,0.04872962775933578,366589,127361,
23,0.17702172099434155,0,234,-211,257,25288,16151,519238,0.04185914358140774,239228,823,0.06976093468445618,46184,1458,514,98,2070,63158,0.02585533850322584,-30033,11,944,9,0.11083802918079518,20,7017,0,4701,607,-2,12325,2316,0.04872962775933578,366589,127361,
23,0.17702172099434155,0,234,-211,257,25288,16151,519238,0.04185914358140774,239228,823,0.06976093468445618,46184,1458,514,98,2070,63158,0.02585533850322584,-30033,11,944,9,0.11083802918079518,20,7017,0,4701,607,-2,12325,2316,0.04872962775933578,366589,127361,
23,0.17702172099434155,0,234,-211,257,25288,16151,519238,0.04185914358140774,239228,823,0.06976093468445618,46184,1458,514,98,2070,63158,0.02585533850322584,-30033,11,944,9,0.11083802918079518,20,7017,0,4701,607,-2,12325,2316,0.04872962775933578,366589,127361,
23,0.17702172099434155,0,234,-211,257,25288,16151,519238,0.04185914358140774,239228,823,0.06976093468445618,46184,1458,514,98,2070,63158,0.02585533850322584,-30033,11,944,9,0.11083802918079518,20,7017,0,4701,607,-2,12325,2316,0.04872962775933578,366589,127361,
23,0.17702172099434155,0,234,-211,257,25288,16151,519238,0.04185914358140774,239228,823,0.06976093468445618,46184,1458,514,98,2070,63158,0.02585533850322584,-30033,11,944,9,0.11083802918079518,20,7017,0,4701,607,-2,12325,2316,0.04872962775933578,366589,127361,
23,0.2608695652173913,0,234,-211,257,25288,16151,519238,0.04185914358140774,239228,823,0.06976093468445618,46184,69,3,0,72,63158,0.02585533850322584,-30033,1,66,5,0.24092477570738438,6,7017,0,4701,607,4,12325,2316,0.04872962775933578,366589,127361,
23,0.2608695652173913,0,234,-211,257,25288,16151,519238,0.04185914358140774,239228,823,0.06976093468445618,46184,69,3,0,72,63158,0.02585533850322584,-30033,1,66,5,0.24092477570738438,6,7017,0,4701,607,4,12325,2316,0.04872962775933578,366589,127361,
23,0.0,0,234,-211,257,25288,16151,519238,0.04185914358140774,239228,823,0.06976093468445618,46184,620,406,4,1030,63158,0.02585533850322584,-30033,0,214,0,0.014050119079047371,0,7017,0,4701,607,0,12325,2316,0.04872962775933578,366589,127361,
23,0.0,0,234,-211,257,25288,16151,519238,0.04185914358140774,239228,823,0.06976093468445618,46184,996,1102,38,2136,63158,0.02585533850322584,-30033,0,-106,0,0.08136632237654626,0,7017,0,4701,607,0,12325,2316,0.04872962775933578,366589,127361,
23,0.002849002849002849,0,234,-211,257,25288,16151,519238,0.04185914358140774,239228,823,0.06976093468445618,46184,626,101,0,727,63158,0.02585533850322584,-30033,0,525,1,0.009875831251033125,1,7017,0,4701,607,1,12325,2316,0.04872962775933578,366589,127361,
0,0.012293086660175269,0,202,-202,202,25288,16151,519238,0.012293086660175269,239228,823,0.06976093468445618,46184,236,235,0,471,63158,0.02585533850322584,-30033,202,1,0,0.1237526079364476,202,236,0,235,0,-202,471,1,0.1237526079364476,366589,127361,
0,0.012293086660175269,0,202,-202,202,25288,16151,519238,0.012293086660175269,239228,823,0.06976093468445618,46184,236,235,0,471,63158,0.02585533850322584,-30033,202,1,0,0.1237526079364476,202,236,0,235,0,-202,471,1,0.1237526079364476,366589,127361,
0,0.012293086660175269,0,202,-202,202,25288,16151,519238,0.012293086660175269,239228,823,0.06976093468445618,46184,236,235,0,471,63158,0.02585533850322584,-30033,202,1,0,0.1237526079364476,202,236,0,235,0,-202,471,1,0.1237526079364476,366589,127361,
0,0.0,0,0,0,0,25288,16151,519238,0.0,239228,823,0.06976093468445618,46184,44,3,0,47,63158,0.02585533850322584,-30033,0,41,0,0.0024674873200770373,0,815,0,199,10,0,1024,616,0.018581759522043075,366589,127361,
0,0.0,0,0,0,0,25288,16151,519238,0.0,239228,823,0.06976093468445618,46184,46,16,0,62,63158,0.02585533850322584,-30033,0,30,0,0.001290504341470211,0,680,0,295,2,0,977,385,0.0027009600450685523,366589,127361,
0,0.0,0,0,0,0,25288,16151,519238,0.0,239228,823,0.06976093468445618,46184,70,47,0,117,63158,0.02585533850322584,-30033,0,23,0,0.0019823238608311085,0,680,0,295,2,0,977,385,0.0027009600450685523,366589,127361,
0,0.0,0,0,0,0,25288,16151,519238,0.0,239228,823,0.06976093468445618,46184,100,43,1,144,63158,0.02585533850322584,-30033,0,57,0,0.0026922861849017496,0,680,0,295,2,0,977,385,0.0027009600450685523,366589,127361,
0,0.0,0,0,0,0,25288,16151,519238,0.0,239228,823,0.06976093468445618,46184,270,131,0,401,63158,0.02585533850322584,-30033,0,139,0,0.007107872565431159,0,680,0,295,2,0,977,385,0.0027009600450685523,366589,127361,
0,0.0,0,0,0,0,25288,16151,519238,0.0,239228,823,0.06976093468445618,46184,270,131,0,401,63158,0.02585533850322584,-30033,0,139,0,0.007107872565431159,0,680,0,295,2,0,977,385,0.0027009600450685523,366589,127361,
0,0.0,0,0,0,0,25288,16151,519238,0.0,239228,823,0.06976093468445618,46184,270,131,0,401,63158,0.02585533850322584,-30033,0,139,0,0.007107872565431159,0,680,0,295,2,0,977,385,0.0027009600450685523,366589,127361,
3,0.0,0,3,0,6,25288,16151,519238,1.857112314975206E-4,239228,823,0.06976093468445618,46184,145,145,0,290,63158,0.02585533850322584,-30033,0,0,0,0.17915425048115335,0,1216,0,1616,83,0,2915,-400,0.06787062213798224,366589,127361,
3,0.0,0,3,0,6,25288,16151,519238,1.857112314975206E-4,239228,823,0.06976093468445618,46184,145,145,0,290,63158,0.02585533850322584,-30033,0,0,0,0.17915425048115335,0,1216,0,1616,83,0,2915,-400,0.06787062213798224,366589,127361,
3,0.0,0,3,0,6,25288,16151,519238,1.857112314975206E-4,239228,823,0.06976093468445618,46184,145,145,0,290,63158,0.02585533850322584,-30033,0,0,0,0.17915425048115335,0,1216,0,1616,83,0,2915,-400,0.06787062213798224,366589,127361,
3,0.002776138326010449,0,3,0,6,25288,16151,519238,1.857112314975206E-4,239228,823,0.06976093468445618,46184,202,107,69,378,63158,0.02585533850322584,-30033,2,95,2,0.042497050772344544,4,1216,0,1616,83,0,2915,-400,0.06787062213798224,366589,127361,
3,0.002776138326010449,0,3,0,6,25288,16151,519238,1.857112314975206E-4,239228,823,0.06976093468445618,46184,202,107,69,378,63158,0.02585533850322584,-30033,2,95,2,0.042497050772344544,4,1216,0,1616,83,0,2915,-400,0.06787062213798224,366589,127361,
3,0.0,0,3,0,6,25288,16151,519238,1.857112314975206E-4,239228,823,0.06976093468445618,46184,3,341,0,344,63158,0.02585533850322584,-30033,0,-338,0,0.09526680848513902,0,1216,0,1616,83,0,2915,-400,0.06787062213798224,366589,127361,
3,0.0,0,3,0,6,25288,16151,519238,1.857112314975206E-4,239228,823,0.06976093468445618,46184,3,341,0,344,63158,0.02585533850322584,-30033,0,-338,0,0.09526680848513902,0,1216,0,1616,83,0,2915,-400,0.06787062213798224,366589,127361,
3,0.0,0,3,0,6,25288,16151,519238,1.857112314975206E-4,239228,823,0.06976093468445618,46184,79,10,0,89,63158,0.02585533850322584,-30033,0,69,0,0.013238468781033777,0,1216,0,1616,83,0,2915,-400,0.06787062213798224,366589,127361,
3,0.0,0,3,0,6,25288,16151,519238,1.857112314975206E-4,239228,823,0.06976093468445618,46184,21,1,0,22,63158,0.02585533850322584,-30033,0,20,0,0.16852955787382018,0,1216,0,1616,83,0,2915,-400,0.06787062213798224,366589,127361,
3,0.0,0,3,0,6,25288,16151,519238,1.857112314975206E-4,239228,823,0.06976093468445618,46184,4,5,0,9,63158,0.02585533850322584,-30033,0,-1,0,0.013574660633484163,0,1216,0,1616,83,0,2915,-400,0.06787062213798224,366589,127361,
12,0.0,0,5,7,17,25288,16151,519238,0.0010769313869795957,239228,823,0.06976093468445618,46184,168,172,0,340,63158,0.02585533850322584,-30033,0,-4,0,0.03205094999297923,0,2131,0,3730,43,0,5904,-1599,0.043951706915400596,366589,127361,
12,0.0,0,5,7,17,25288,16151,519238,0.0010769313869795957,239228,823,0.06976093468445618,46184,30,250,2,282,63158,0.02585533850322584,-30033,0,-220,0,0.09584122148666274,0,2131,0,3730,43,0,5904,-1599,0.043951706915400596,366589,127361,
12,0.0,0,5,7,17,25288,16151,519238,0.0010769313869795957,239228,823,0.06976093468445618,46184,98,752,39,889,63158,0.02585533850322584,-30033,0,-654,0,0.23190203194082107,0,2131,0,3730,43,0,5904,-1599,0.043951706915400596,366589,127361,
12,0.0,0,5,7,17,25288,16151,519238,0.0010769313869795957,239228,823,0.06976093468445618,46184,98,752,39,889,63158,0.02585533850322584,-30033,0,-654,0,0.23190203194082107,0,2131,0,3730,43,0,5904,-1599,0.043951706915400596,366589,127361,
12,0.0,0,5,7,17,25288,16151,519238,0.0010769313869795957,239228,823,0.06976093468445618,46184,98,752,39,889,63158,0.02585533850322584,-30033,0,-654,0,0.23190203194082107,0,2131,0,3730,43,0,5904,-1599,0.043951706915400596,366589,127361,
12,0.0,0,5,7,17,25288,16151,519238,0.0010769313869795957,239228,823,0.06976093468445618,46184,98,752,39,889,63158,0.02585533850322584,-30033,0,-654,0,0.23190203194082107,0,2131,0,3730,43,0,5904,-1599,0.043951706915400596,366589,127361,
12,0.0,0,5,7,17,25288,16151,519238,0.0010769313869795957,239228,823,0.06976093468445618,46184,105,105,0,210,63158,0.02585533850322584,-30033,0,0,0,0.018444008392086538,0,2131,0,3730,43,0,5904,-1599,0.043951706915400596,366589,127361,
12,0.0,0,5,7,17,25288,16151,519238,0.0010769313869795957,239228,823,0.06976093468445618,46184,105,105,0,210,63158,0.02585533850322584,-30033,0,0,0,0.018444008392086538,0,2131,0,3730,43,0,5904,-1599,0.043951706915400596,366589,127361,
12,0.0,0,5,7,17,25288,16151,519238,0.0010769313869795957,239228,823,0.06976093468445618,46184,207,182,0,389,63158,0.02585533850322584,-30033,0,25,0,0.04984695310525317,0,2131,0,3730,43,0,5904,-1599,0.043951706915400596,366589,127361,
2,0.0,0,3101,-3099,3103,25288,16151,519238,0.014559855585234946,239228,823,0.06976093468445618,46184,172,0,0,172,63158,0.02585533850322584,-30033,0,172,0,0.2792207792207792,0,3717,0,3616,100,0,7433,101,0.07130379808974095,366589,127361,
2,0.020829624354637706,0,3101,-3099,3103,25288,16151,519238,0.014559855585234946,239228,823,0.06976093468445618,46184,176,374,38,588,63158,0.02585533850322584,-30033,351,-198,0,0.16146837078336523,351,3717,0,3616,100,-351,7433,101,0.07130379808974095,366589,127361,
2,0.04424635332252836,0,3101,-3099,3103,25288,16151,519238,0.014559855585234946,239228,823,0.06976093468445618,46184,903,996,19,1918,63158,0.02585533850322584,-30033,819,-93,0,0.17295242867236352,819,3717,0,3616,100,-819,7433,101,0.07130379808974095,366589,127361,
2,0.04424635332252836,0,3101,-3099,3103,25288,16151,519238,0.014559855585234946,239228,823,0.06976093468445618,46184,903,996,19,1918,63158,0.02585533850322584,-30033,819,-93,0,0.17295242867236352,819,3717,0,3616,100,-819,7433,101,0.07130379808974095,366589,127361,
2,0.016847998309918667,0,3101,-3099,3103,25288,16151,519238,0.014559855585234946,239228,823,0.06976093468445618,46184,59,357,6,422,63158,0.02585533850322584,-30033,319,-298,0,0.05616554503475051,319,3717,0,3616,100,-319,7433,101,0.07130379808974095,366589,127361,
2,0.0,0,3101,-3099,3103,25288,16151,519238,0.014559855585234946,239228,823,0.06976093468445618,46184,66,6,0,72,63158,0.02585533850322584,-30033,0,60,0,0.09583814991038293,0,3717,0,3616,100,0,7433,101,0.07130379808974095,366589,127361,
2,0.0,0,3101,-3099,3103,25288,16151,519238,0.014559855585234946,239228,823,0.06976093468445618,46184,275,44,1,320,63158,0.02585533850322584,-30033,0,231,0,0.06863594836857673,0,3717,0,3616,100,0,7433,101,0.07130379808974095,366589,127361,
2,0.0,0,3101,-3099,3103,25288,16151,519238,0.014559855585234946,239228,823,0.06976093468445618,46184,149,6,0,155,63158,0.02585533850322584,-30033,0,143,0,0.002094434448611247,0,3717,0,3616,100,0,7433,101,0.07130379808974095,366589,127361,
2,0.0,0,3101,-3099,3103,25288,16151,519238,0.014559855585234946,239228,823,0.06976093468445618,46184,200,2,0,202,63158,0.02585533850322584,-30033,0,198,0,0.01049817756149298,0,3717,0,3616,100,0,7433,101,0.07130379808974095,366589,127361,
2,0.0,0,3101,-3099,3103,25288,16151,519238,0.014559855585234946,239228,823,0.06976093468445618,46184,200,2,0,202,63158,0.02585533850322584,-30033,0,198,0,0.01049817756149298,0,3717,0,3616,100,0,7433,101,0.07130379808974095,366589,127361,
0,0.0,0,0,0,0,25288,16151,519238,0.0,239228,823,0.06976093468445618,46184,269,26,1,296,63158,0.02585533850322584,-30033,0,243,0,0.016650520495402568,0,583,0,67,19,0,669,516,0.009957119287187436,366589,127361,
9,0.16071428571428573,0,9,0,18,25288,16151,519238,0.053571428571428575,239228,823,0.06976093468445618,46184,927,9,0,936,63158,0.02585533850322584,-30033,9,918,9,0.16816194146352514,18,1361,0,9,0,0,1370,1352,0.0693217678669547,366589,127361,
9,0.16071428571428573,0,9,0,18,25288,16151,519238,0.053571428571428575,239228,823,0.06976093468445618,46184,927,9,0,936,63158,0.02585533850322584,-30033,9,918,9,0.16816194146352514,18,1361,0,9,0,0,1370,1352,0.0693217678669547,366589,127361,
9,0.16071428571428573,0,9,0,18,25288,16151,519238,0.053571428571428575,239228,823,0.06976093468445618,46184,927,9,0,936,63158,0.02585533850322584,-30033,9,918,9,0.16816194146352514,18,1361,0,9,0,0,1370,1352,0.0693217678669547,366589,127361,
9,0.16071428571428573,0,9,0,18,25288,16151,519238,0.053571428571428575,239228,823,0.06976093468445618,46184,927,9,0,936,63158,0.02585533850322584,-30033,9,918,9,0.16816194146352514,18,1361,0,9,0,0,1370,1352,0.0693217678669547,366589,127361,
9,0.16071428571428573,0,9,0,18,25288,16151,519238,0.053571428571428575,239228,823,0.06976093468445618,46184,927,9,0,936,63158,0.02585533850322584,-30033,9,918,9,0.16816194146352514,18,1361,0,9,0,0,1370,1352,0.0693217678669547,366589,127361,
416,0.0,0,2,414,418,25288,16151,519238,0.007108983128134975,239228,823,0.06976093468445618,46184,162,22,0,184,63158,0.02585533850322584,-30033,0,140,0,0.07826009857314928,0,2265,0,199,15,0,2479,2066,0.037889781920842296,366589,127361,
416,0.0,0,2,414,418,25288,16151,519238,0.007108983128134975,239228,823,0.06976093468445618,46184,162,22,0,184,63158,0.02585533850322584,-30033,0,140,0,0.07826009857314928,0,2265,0,199,15,0,2479,2066,0.037889781920842296,366589,127361,
21,0.0029265657828701696,0,12,9,33,25288,16151,519238,0.00364369953269663,239228,823,0.06976093468445618,46184,43,45,5,93,63158,0.02585533850322584,-30033,1,-2,6,0.024712069918004814,7,516,0,62,5,5,583,454,0.008066967465319472,366589,127361,
21,0.0029265657828701696,0,12,9,33,25288,16151,519238,0.00364369953269663,239228,823,0.06976093468445618,46184,43,45,5,93,63158,0.02585533850322584,-30033,1,-2,6,0.024712069918004814,7,516,0,62,5,5,583,454,0.008066967465319472,366589,127361,
48,0.0342732679071118,0,3,45,51,25288,16151,519238,0.0561854715493126,239228,823,0.06976093468445618,46184,272,222,115,609,63158,0.02585533850322584,-30033,3,50,6,0.09487600834902482,9,499,0,318,121,3,938,181,0.10527040643874834,366589,127361,
48,0.26811594202898553,0,3,45,51,25288,16151,519238,0.0561854715493126,239228,823,0.06976093468445618,46184,83,23,1,107,63158,0.02585533850322584,-30033,0,60,37,0.06324955469823856,37,499,0,318,121,37,938,181,0.10527040643874834,366589,127361,
48,0.26811594202898553,0,3,45,51,25288,16151,519238,0.0561854715493126,239228,823,0.06976093468445618,46184,83,23,1,107,63158,0.02585533850322584,-30033,0,60,37,0.06324955469823856,37,499,0,318,121,37,938,181,0.10527040643874834,366589,127361,
48,0.26811594202898553,0,3,45,51,25288,16151,519238,0.0561854715493126,239228,823,0.06976093468445618,46184,83,23,1,107,63158,0.02585533850322584,-30033,0,60,37,0.06324955469823856,37,499,0,318,121,37,938,181,0.10527040643874834,366589,127361,
292,0.5652953586497891,0,0,292,292,25288,16151,519238,0.5652953586497891,239228,823,0.06976093468445618,46184,292,0,0,292,63158,0.02585533850322584,-30033,0,292,292,0.5652953586497891,292,292,0,0,0,292,292,292,0.5652953586497891,366589,127361,
0,0.0,0,0,0,0,25288,16151,519238,0.0,239228,823,0.06976093468445618,46184,19,0,0,19,63158,0.02585533850322584,-30033,0,19,0,0.13380281690140844,0,22,0,3,0,0,25,19,0.06789577371421102,366589,127361,
0,0.0,0,0,0,0,25288,16151,519238,0.0,239228,823,0.06976093468445618,46184,3,3,0,6,63158,0.02585533850322584,-30033,0,0,0,0.0019887305270135896,0,22,0,3,0,0,25,19,0.06789577371421102,366589,127361,
0,0.0,0,0,0,0,25288,16151,519238,0.0,239228,823,0.06976093468445618,46184,3,3,0,6,63158,0.02585533850322584,-30033,0,0,0,0.0019887305270135896,0,22,0,3,0,0,25,19,0.06789577371421102,366589,127361,
0,0.0,0,0,0,0,25288,16151,519238,0.0,239228,823,0.06976093468445618,46184,193,3,0,196,63158,0.02585533850322584,-30033,0,190,0,0.2716430875798673,0,258,0,8,0,0,266,250,0.26256382978699994,366589,127361,
0,0.0,0,0,0,0,25288,16151,519238,0.0,239228,823,0.06976093468445618,46184,5,5,0,10,63158,0.02585533850322584,-30033,0,0,0,0.0032278889606197547,0,258,0,8,0,0,266,250,0.26256382978699994,366589,127361,
0,0.0,0,0,0,0,25288,16151,519238,0.0,239228,823,0.06976093468445618,46184,5,5,0,10,63158,0.02585533850322584,-30033,0,0,0,0.0032278889606197547,0,258,0,8,0,0,266,250,0.26256382978699994,366589,127361,
0,0.0,0,0,0,0,25288,16151,519238,0.0,239228,823,0.06976093468445618,46184,5,5,0,10,63158,0.02585533850322584,-30033,0,0,0,0.0032278889606197547,0,258,0,8,0,0,266,250,0.26256382978699994,366589,127361,
0,0.0,0,0,0,0,25288,16151,519238,0.0,239228,823,0.06976093468445618,46184,5,5,0,10,63158,0.02585533850322584,-30033,0,0,0,0.0032278889606197547,0,258,0,8,0,0,266,250,0.26256382978699994,366589,127361,
0,0.0,0,0,0,0,25288,16151,519238,0.0,239228,823,0.06976093468445618,46184,5,5,0,10,63158,0.02585533850322584,-30033,0,0,0,0.0032278889606197547,0,258,0,8,0,0,266,250,0.26256382978699994,366589,127361,
0,0.0,0,0,0,0,25288,16151,519238,0.0,239228,823,0.06976093468445618,46184,5,5,0,10,63158,0.02585533850322584,-30033,0,0,0,0.0032278889606197547,0,258,0,8,0,0,266,250,0.26256382978699994,366589,127361,
0,0.0,0,0,0,0,25288,16151,519238,0.0,239228,823,0.06976093468445618,46184,5,5,0,10,63158,0.02585533850322584,-30033,0,0,0,0.0032278889606197547,0,258,0,8,0,0,266,250,0.26256382978699994,366589,127361,
242,0.05054151624548736,9,69,173,320,25288,16151,519238,0.03154355156157414,239228,823,0.06976093468445618,46184,576,72,44,692,63158,0.02585533850322584,-30033,2,504,12,0.10043095815117371,14,3498,0,286,67,10,3851,3212,0.06396364572454749,366589,127361,
242,0.1146228576467034,9,69,173,320,25288,16151,519238,0.03154355156157414,239228,823,0.06976093468445618,46184,85,15,0,100,63158,0.02585533850322584,-30033,13,70,67,0.06927768792006253,80,3498,0,286,67,54,3851,3212,0.06396364572454749,366589,127361,
242,0.1146228576467034,9,69,173,320,25288,16151,519238,0.03154355156157414,239228,823,0.06976093468445618,46184,85,15,0,100,63158,0.02585533850322584,-30033,13,70,67,0.06927768792006253,80,3498,0,286,67,54,3851,3212,0.06396364572454749,366589,127361,
242,0.0,9,69,173,320,25288,16151,519238,0.03154355156157414,239228,823,0.06976093468445618,46184,78,0,0,78,63158,0.02585533850322584,-30033,0,78,0,0.0032599074358179367,0,3498,0,286,67,0,3851,3212,0.06396364572454749,366589,127361,
242,0.005128205128205128,9,69,173,320,25288,16151,519238,0.03154355156157414,239228,823,0.06976093468445618,46184,61,11,0,72,63158,0.02585533850322584,-30033,1,50,1,0.007999967578801313,2,3498,0,286,67,0,3851,3212,0.06396364572454749,366589,127361,
242,0.0,9,69,173,320,25288,16151,519238,0.03154355156157414,239228,823,0.06976093468445618,46184,116,0,0,116,63158,0.02585533850322584,-30033,0,116,0,0.004778191959731175,0,3498,0,286,67,0,3851,3212,0.06396364572454749,366589,127361,
242,0.004464285714285714,9,69,173,320,25288,16151,519238,0.03154355156157414,239228,823,0.06976093468445618,46184,267,19,0,286,63158,0.02585533850322584,-30033,1,248,1,0.038124573198708,2,3498,0,286,67,0,3851,3212,0.06396364572454749,366589,127361,
242,0.1530520893262494,9,69,173,320,25288,16151,519238,0.03154355156157414,239228,823,0.06976093468445618,46184,490,32,20,542,63158,0.02585533850322584,-30033,8,458,68,0.07564158941325012,85,3498,9,286,67,60,3851,3212,0.06396364572454749,366589,127361,
242,0.13391338902274805,9,69,173,320,25288,16151,519238,0.03154355156157414,239228,823,0.06976093468445618,46184,1094,59,0,1153,63158,0.02585533850322584,-30033,24,1035,61,0.11369655494258428,85,3498,0,286,67,37,3851,3212,0.06396364572454749,366589,127361,
242,0.13391338902274805,9,69,173,320,25288,16151,519238,0.03154355156157414,239228,823,0.06976093468445618,46184,1094,59,0,1153,63158,0.02585533850322584,-30033,24,1035,61,0.11369655494258428,85,3498,0,286,67,37,3851,3212,0.06396364572454749,366589,127361,
242,0.13391338902274805,9,69,173,320,25288,16151,519238,0.03154355156157414,239228,823,0.06976093468445618,46184,1094,59,0,1153,63158,0.02585533850322584,-30033,24,1035,61,0.11369655494258428,85,3498,0,286,67,37,3851,3212,0.06396364572454749,366589,127361,
242,0.0106951871657754,9,69,173,320,25288,16151,519238,0.03154355156157414,239228,823,0.06976093468445618,46184,259,23,2,284,63158,0.02585533850322584,-30033,3,236,3,0.036890012499769316,6,3498,0,286,67,0,3851,3212,0.06396364572454749,366589,127361,
242,0.0106951871657754,9,69,173,320,25288,16151,519238,0.03154355156157414,239228,823,0.06976093468445618,46184,259,23,2,284,63158,0.02585533850322584,-30033,3,236,3,0.036890012499769316,6,3498,0,286,67,0,3851,3212,0.06396364572454749,366589,127361,
242,0.0106951871657754,9,69,173,320,25288,16151,519238,0.03154355156157414,239228,823,0.06976093468445618,46184,259,23,2,284,63158,0.02585533850322584,-30033,3,236,3,0.036890012499769316,6,3498,0,286,67,0,3851,3212,0.06396364572454749,366589,127361,
242,0.003430531732418525,9,69,173,320,25288,16151,519238,0.03154355156157414,239228,823,0.06976093468445618,46184,134,6,0,140,63158,0.02585533850322584,-30033,1,128,1,0.004035735171696511,2,3498,0,286,67,0,3851,3212,0.06396364572454749,366589,127361,
12,0.0,48,18,-6,78,25288,16151,519238,0.05257814064137745,239228,823,0.06976093468445618,46184,1,1,0,2,63158,0.02585533850322584,-30033,0,0,0,7.8064012490242E-4,0,181,0,25,48,0,254,156,0.07178341566095618,366589,127361,
754,0.15848127264901196,38,110,644,902,25288,16151,519238,0.05651900053449775,239228,823,0.06976093468445618,46184,921,1152,125,2198,63158,0.02585533850322584,-30033,13,-231,42,0.18643246645695583,63,7819,8,2260,352,29,10431,5559,0.05379264694478659,366589,127361,
754,0.0301061295213342,38,110,644,902,25288,16151,519238,0.05651900053449775,239228,823,0.06976093468445618,46184,151,1,0,152,63158,0.02585533850322584,-30033,1,150,151,0.0301061295213342,152,7819,0,2260,352,150,10431,5559,0.05379264694478659,366589,127361,
754,0.0301061295213342,38,110,644,902,25288,16151,519238,0.05651900053449775,239228,823,0.06976093468445618,46184,151,1,0,152,63158,0.02585533850322584,-30033,1,150,151,0.0301061295213342,152,7819,0,2260,352,150,10431,5559,0.05379264694478659,366589,127361,
754,0.0301061295213342,38,110,644,902,25288,16151,519238,0.05651900053449775,239228,823,0.06976093468445618,46184,151,1,0,152,63158,0.02585533850322584,-30033,1,150,151,0.0301061295213342,152,7819,0,2260,352,150,10431,5559,0.05379264694478659,366589,127361,
754,0.03389830508474576,38,110,644,902,25288,16151,519238,0.05651900053449775,239228,823,0.06976093468445618,46184,42,5,18,65,63158,0.02585533850322584,-30033,1,37,1,0.02287318782337543,2,7819,0,2260,352,0,10431,5559,0.05379264694478659,366589,127361,
754,0.379746835443038,38,110,644,902,25288,16151,519238,0.05651900053449775,239228,823,0.06976093468445618,46184,122,47,20,189,63158,0.02585533850322584,-30033,3,75,27,0.3688627651414663,30,7819,0,2260,352,24,10431,5559,0.05379264694478659,366589,127361,
754,0.0,38,110,644,902,25288,16151,519238,0.05651900053449775,239228,823,0.06976093468445618,46184,15,11,0,26,63158,0.02585533850322584,-30033,0,4,0,0.03523035230352303,0,7819,0,2260,352,0,10431,5559,0.05379264694478659,366589,127361,
754,0.4519230769230769,38,110,644,902,25288,16151,519238,0.05651900053449775,239228,823,0.06976093468445618,46184,27,9,12,48,63158,0.02585533850322584,-30033,8,18,27,0.22742352676563204,47,7819,12,2260,352,19,10431,5559,0.05379264694478659,366589,127361,
754,0.4519230769230769,38,110,644,902,25288,16151,519238,0.05651900053449775,239228,823,0.06976093468445618,46184,27,9,12,48,63158,0.02585533850322584,-30033,8,18,27,0.22742352676563204,47,7819,12,2260,352,19,10431,5559,0.05379264694478659,366589,127361,
754,0.21835092384830604,38,110,644,902,25288,16151,519238,0.05651900053449775,239228,823,0.06976093468445618,46184,691,59,65,815,63158,0.02585533850322584,-30033,38,632,57,0.20883731163128064,112,7819,17,2260,352,19,10431,5559,0.05379264694478659,366589,127361,
754,0.0,38,110,644,902,25288,16151,519238,0.05651900053449775,239228,823,0.06976093468445618,46184,25,0,0,25,63158,0.02585533850322584,-30033,0,25,0,0.06510416666666667,0,7819,0,2260,352,0,10431,5559,0.05379264694478659,366589,127361,
754,0.0,38,110,644,902,25288,16151,519238,0.05651900053449775,239228,823,0.06976093468445618,46184,95,4,0,99,63158,0.02585533850322584,-30033,0,91,0,0.011254674406949619,0,7819,0,2260,352,0,10431,5559,0.05379264694478659,366589,127361,
75,0.04484007365523996,1,185,-110,261,25288,16151,519238,0.04532531330276966,239228,823,0.06976093468445618,46184,2157,594,80,2831,63158,0.02585533850322584,-30033,67,1563,19,0.06732979040197529,87,7090,1,1893,182,-48,9165,5197,0.034297309731734164,366589,127361,
75,0.04484007365523996,1,185,-110,261,25288,16151,519238,0.04532531330276966,239228,823,0.06976093468445618,46184,2157,594,80,2831,63158,0.02585533850322584,-30033,67,1563,19,0.06732979040197529,87,7090,1,1893,182,-48,9165,5197,0.034297309731734164,366589,127361,
75,0.04484007365523996,1,185,-110,261,25288,16151,519238,0.04532531330276966,239228,823,0.06976093468445618,46184,2157,594,80,2831,63158,0.02585533850322584,-30033,67,1563,19,0.06732979040197529,87,7090,1,1893,182,-48,9165,5197,0.034297309731734164,366589,127361,
75,0.04484007365523996,1,185,-110,261,25288,16151,519238,0.04532531330276966,239228,823,0.06976093468445618,46184,2157,594,80,2831,63158,0.02585533850322584,-30033,67,1563,19,0.06732979040197529,87,7090,1,1893,182,-48,9165,5197,0.034297309731734164,366589,127361,
75,0.04484007365523996,1,185,-110,261,25288,16151,519238,0.04532531330276966,239228,823,0.06976093468445618,46184,2157,594,80,2831,63158,0.02585533850322584,-30033,67,1563,19,0.06732979040197529,87,7090,1,1893,182,-48,9165,5197,0.034297309731734164,366589,127361,
75,0.04484007365523996,1,185,-110,261,25288,16151,519238,0.04532531330276966,239228,823,0.06976093468445618,46184,2157,594,80,2831,63158,0.02585533850322584,-30033,67,1563,19,0.06732979040197529,87,7090,1,1893,182,-48,9165,5197,0.034297309731734164,366589,127361,
75,0.04484007365523996,1,185,-110,261,25288,16151,519238,0.04532531330276966,239228,823,0.06976093468445618,46184,2157,594,80,2831,63158,0.02585533850322584,-30033,67,1563,19,0.06732979040197529,87,7090,1,1893,182,-48,9165,5197,0.034297309731734164,366589,127361,
75,0.1275382365967154,1,185,-110,261,25288,16151,519238,0.04532531330276966,239228,823,0.06976093468445618,46184,614,191,25,830,63158,0.02585533850322584,-30033,25,423,38,0.075099687328797,63,7090,0,1893,182,13,9165,5197,0.034297309731734164,366589,127361,
75,0.05204116059379217,1,185,-110,261,25288,16151,519238,0.04532531330276966,239228,823,0.06976093468445618,46184,656,161,44,861,63158,0.02585533850322584,-30033,9,495,2,0.0648461706688025,11,7090,0,1893,182,-7,9165,5197,0.034297309731734164,366589,127361,
75,0.05204116059379217,1,185,-110,261,25288,16151,519238,0.04532531330276966,239228,823,0.06976093468445618,46184,656,161,44,861,63158,0.02585533850322584,-30033,9,495,2,0.0648461706688025,11,7090,0,1893,182,-7,9165,5197,0.034297309731734164,366589,127361,
75,0.05204116059379217,1,185,-110,261,25288,16151,519238,0.04532531330276966,239228,823,0.06976093468445618,46184,656,161,44,861,63158,0.02585533850322584,-30033,9,495,2,0.0648461706688025,11,7090,0,1893,182,-7,9165,5197,0.034297309731734164,366589,127361,
75,0.05204116059379217,1,185,-110,261,25288,16151,519238,0.04532531330276966,239228,823,0.06976093468445618,46184,656,161,44,861,63158,0.02585533850322584,-30033,9,495,2,0.0648461706688025,11,7090,0,1893,182,-7,9165,5197,0.034297309731734164,366589,127361,
75,0.05204116059379217,1,185,-110,261,25288,16151,519238,0.04532531330276966,239228,823,0.06976093468445618,46184,656,161,44,861,63158,0.02585533850322584,-30033,9,495,2,0.0648461706688025,11,7090,0,1893,182,-7,9165,5197,0.034297309731734164,366589,127361,
75,0.05204116059379217,1,185,-110,261,25288,16151,519238,0.04532531330276966,239228,823,0.06976093468445618,46184,656,161,44,861,63158,0.02585533850322584,-30033,9,495,2,0.0648461706688025,11,7090,0,1893,182,-7,9165,5197,0.034297309731734164,366589,127361,
75,0.05204116059379217,1,185,-110,261,25288,16151,519238,0.04532531330276966,239228,823,0.06976093468445618,46184,656,161,44,861,63158,0.02585533850322584,-30033,9,495,2,0.0648461706688025,11,7090,0,1893,182,-7,9165,5197,0.034297309731734164,366589,127361,
75,0.05204116059379217,1,185,-110,261,25288,16151,519238,0.04532531330276966,239228,823,0.06976093468445618,46184,656,161,44,861,63158,0.02585533850322584,-30033,9,495,2,0.0648461706688025,11,7090,0,1893,182,-7,9165,5197,0.034297309731734164,366589,127361,
75,0.05204116059379217,1,185,-110,261,25288,16151,519238,0.04532531330276966,239228,823,0.06976093468445618,46184,656,161,44,861,63158,0.02585533850322584,-30033,9,495,2,0.0648461706688025,11,7090,0,1893,182,-7,9165,5197,0.034297309731734164,366589,127361,
75,0.05204116059379217,1,185,-110,261,25288,16151,519238,0.04532531330276966,239228,823,0.06976093468445618,46184,656,161,44,861,63158,0.02585533850322584,-30033,9,495,2,0.0648461706688025,11,7090,0,1893,182,-7,9165,5197,0.034297309731734164,366589,127361,
75,0.05204116059379217,1,185,-110,261,25288,16151,519238,0.04532531330276966,239228,823,0.06976093468445618,46184,656,161,44,861,63158,0.02585533850322584,-30033,9,495,2,0.0648461706688025,11,7090,0,1893,182,-7,9165,5197,0.034297309731734164,366589,127361,
75,0.072,1,185,-110,261,25288,16151,519238,0.04532531330276966,239228,823,0.06976093468445618,46184,544,49,20,613,63158,0.02585533850322584,-30033,9,495,0,0.06413990126783851,9,7090,0,1893,182,-9,9165,5197,0.034297309731734164,366589,127361,
75,0.072,1,185,-110,261,25288,16151,519238,0.04532531330276966,239228,823,0.06976093468445618,46184,544,49,20,613,63158,0.02585533850322584,-30033,9,495,0,0.06413990126783851,9,7090,0,1893,182,-9,9165,5197,0.034297309731734164,366589,127361,
75,0.072,1,185,-110,261,25288,16151,519238,0.04532531330276966,239228,823,0.06976093468445618,46184,544,49,20,613,63158,0.02585533850322584,-30033,9,495,0,0.06413990126783851,9,7090,0,1893,182,-9,9165,5197,0.034297309731734164,366589,127361,
75,0.072,1,185,-110,261,25288,16151,519238,0.04532531330276966,239228,823,0.06976093468445618,46184,544,49,20,613,63158,0.02585533850322584,-30033,9,495,0,0.06413990126783851,9,7090,0,1893,182,-9,9165,5197,0.034297309731734164,366589,127361,
75,0.072,1,185,-110,261,25288,16151,519238,0.04532531330276966,239228,823,0.06976093468445618,46184,544,49,20,613,63158,0.02585533850322584,-30033,9,495,0,0.06413990126783851,9,7090,0,1893,182,-9,9165,5197,0.034297309731734164,366589,127361,
75,0.0,1,185,-110,261,25288,16151,519238,0.04532531330276966,239228,823,0.06976093468445618,46184,461,47,0,508,63158,0.02585533850322584,-30033,0,414,0,0.027589839640521186,0,7090,0,1893,182,0,9165,5197,0.034297309731734164,366589,127361,
75,0.0,1,185,-110,261,25288,16151,519238,0.04532531330276966,239228,823,0.06976093468445618,46184,461,47,0,508,63158,0.02585533850322584,-30033,0,414,0,0.027589839640521186,0,7090,0,1893,182,0,9165,5197,0.034297309731734164,366589,127361,
75,0.0,1,185,-110,261,25288,16151,519238,0.04532531330276966,239228,823,0.06976093468445618,46184,461,47,0,508,63158,0.02585533850322584,-30033,0,414,0,0.027589839640521186,0,7090,0,1893,182,0,9165,5197,0.034297309731734164,366589,127361,
75,0.0,1,185,-110,261,25288,16151,519238,0.04532531330276966,239228,823,0.06976093468445618,46184,461,47,0,508,63158,0.02585533850322584,-30033,0,414,0,0.027589839640521186,0,7090,0,1893,182,0,9165,5197,0.034297309731734164,366589,127361,
75,0.0,1,185,-110,261,25288,16151,519238,0.04532531330276966,239228,823,0.06976093468445618,46184,461,47,0,508,63158,0.02585533850322584,-30033,0,414,0,0.027589839640521186,0,7090,0,1893,182,0,9165,5197,0.034297309731734164,366589,127361,
75,0.10826771653543307,1,185,-110,261,25288,16151,519238,0.04532531330276966,239228,823,0.06976093468445618,46184,392,102,0,494,63158,0.02585533850322584,-30033,51,290,4,0.02344865570785958,55,7090,0,1893,182,-47,9165,5197,0.034297309731734164,366589,127361,
75,0.10826771653543307,1,185,-110,261,25288,16151,519238,0.04532531330276966,239228,823,0.06976093468445618,46184,392,102,0,494,63158,0.02585533850322584,-30033,51,290,4,0.02344865570785958,55,7090,0,1893,182,-47,9165,5197,0.034297309731734164,366589,127361,
75,0.10826771653543307,1,185,-110,261,25288,16151,519238,0.04532531330276966,239228,823,0.06976093468445618,46184,392,102,0,494,63158,0.02585533850322584,-30033,51,290,4,0.02344865570785958,55,7090,0,1893,182,-47,9165,5197,0.034297309731734164,366589,127361,
75,0.10826771653543307,1,185,-110,261,25288,16151,519238,0.04532531330276966,239228,823,0.06976093468445618,46184,392,102,0,494,63158,0.02585533850322584,-30033,51,290,4,0.02344865570785958,55,7090,0,1893,182,-47,9165,5197,0.034297309731734164,366589,127361,
75,0.1291825735459241,1,185,-110,261,25288,16151,519238,0.04532531330276966,239228,823,0.06976093468445618,46184,298,88,3,389,63158,0.02585533850322584,-30033,10,210,11,0.027403719394933482,21,7090,0,1893,182,1,9165,5197,0.034297309731734164,366589,127361,
152,0.16861317991643499,6,120,32,278,25288,16151,519238,0.05099547509928054,239228,823,0.06976093468445618,46184,41,86,9,136,63158,0.02585533850322584,-30033,18,-45,22,0.07908448076339801,40,848,0,418,15,4,1281,430,0.02895210654357599,366589,127361,
152,0.16861317991643499,6,120,32,278,25288,16151,519238,0.05099547509928054,239228,823,0.06976093468445618,46184,41,86,9,136,63158,0.02585533850322584,-30033,18,-45,22,0.07908448076339801,40,848,0,418,15,4,1281,430,0.02895210654357599,366589,127361,
152,0.014450867052023121,6,120,32,278,25288,16151,519238,0.05099547509928054,239228,823,0.06976093468445618,46184,54,192,0,246,63158,0.02585533850322584,-30033,1,-138,4,0.018031301785576416,5,848,0,418,15,3,1281,430,0.02895210654357599,366589,127361,
152,0.12591122295868334,6,120,32,278,25288,16151,519238,0.05099547509928054,239228,823,0.06976093468445618,46184,287,21,6,314,63158,0.02585533850322584,-30033,21,266,86,0.07066541898457433,113,848,6,418,15,65,1281,430,0.02895210654357599,366589,127361,
48,0.0,0,5,43,53,25288,16151,519238,0.016917576439842142,239228,823,0.06976093468445618,46184,39,38,0,77,63158,0.02585533850322584,-30033,0,1,0,0.506578947368421,0,656,0,57,0,0,713,599,0.08282237772192536,366589,127361,
48,0.0,0,5,43,53,25288,16151,519238,0.016917576439842142,239228,823,0.06976093468445618,46184,1,0,0,1,63158,0.02585533850322584,-30033,0,1,0,0.00267379679144385,0,656,0,57,0,0,713,599,0.08282237772192536,366589,127361,
48,0.0,0,5,43,53,25288,16151,519238,0.016917576439842142,239228,823,0.06976093468445618,46184,1,0,0,1,63158,0.02585533850322584,-30033,0,1,0,0.00267379679144385,0,656,0,57,0,0,713,599,0.08282237772192536,366589,127361,
48,0.0,0,5,43,53,25288,16151,519238,0.016917576439842142,239228,823,0.06976093468445618,46184,19,0,0,19,63158,0.02585533850322584,-30033,0,19,0,0.10555555555555556,0,656,0,57,0,0,713,599,0.08282237772192536,366589,127361,
48,0.2222222222222222,0,5,43,53,25288,16151,519238,0.016917576439842142,239228,823,0.06976093468445618,46184,106,4,0,110,63158,0.02585533850322584,-30033,3,102,3,0.05715622016626679,6,656,0,57,0,0,713,599,0.08282237772192536,366589,127361,
48,0.2222222222222222,0,5,43,53,25288,16151,519238,0.016917576439842142,239228,823,0.06976093468445618,46184,106,4,0,110,63158,0.02585533850322584,-30033,3,102,3,0.05715622016626679,6,656,0,57,0,0,713,599,0.08282237772192536,366589,127361,
17,0.044444444444444446,0,229,-212,246,25288,16151,519238,0.024599037930455883,239228,823,0.06976093468445618,46184,1201,229,11,1441,63158,0.02585533850322584,-30033,1,972,1,0.14523389622043573,2,1935,0,679,14,0,2628,1256,0.058887160383082726,366589,127361,
17,0.044444444444444446,0,229,-212,246,25288,16151,519238,0.024599037930455883,239228,823,0.06976093468445618,46184,1201,229,11,1441,63158,0.02585533850322584,-30033,1,972,1,0.14523389622043573,2,1935,0,679,14,0,2628,1256,0.058887160383082726,366589,127361,
17,0.044444444444444446,0,229,-212,246,25288,16151,519238,0.024599037930455883,239228,823,0.06976093468445618,46184,1201,229,11,1441,63158,0.02585533850322584,-30033,1,972,1,0.14523389622043573,2,1935,0,679,14,0,2628,1256,0.058887160383082726,366589,127361,
17,0.044444444444444446,0,229,-212,246,25288,16151,519238,0.024599037930455883,239228,823,0.06976093468445618,46184,1201,229,11,1441,63158,0.02585533850322584,-30033,1,972,1,0.14523389622043573,2,1935,0,679,14,0,2628,1256,0.058887160383082726,366589,127361,
17,0.010354585017423937,0,229,-212,246,25288,16151,519238,0.024599037930455883,239228,823,0.06976093468445618,46184,131,393,0,524,63158,0.02585533850322584,-30033,225,-262,1,0.013757930270592657,226,1935,0,679,14,-224,2628,1256,0.058887160383082726,366589,127361,
29,0.08258419646928539,0,5,24,34,25288,16151,519238,0.18602894033990586,239228,823,0.06976093468445618,46184,59,12,0,71,63158,0.02585533850322584,-30033,3,47,20,0.05272066966321412,23,169,0,15,0,17,184,154,0.07775342010333476,366589,127361,
232,0.0,17,76,156,325,25288,16151,519238,0.024671525064917346,239228,823,0.06976093468445618,46184,134,0,0,134,63158,0.02585533850322584,-30033,0,134,0,0.2838983050847458,0,7068,0,392,157,0,7617,6676,0.04841239522556135,366589,127361,
232,0.0,17,76,156,325,25288,16151,519238,0.024671525064917346,239228,823,0.06976093468445618,46184,134,0,0,134,63158,0.02585533850322584,-30033,0,134,0,0.2838983050847458,0,7068,0,392,157,0,7617,6676,0.04841239522556135,366589,127361,
232,0.0,17,76,156,325,25288,16151,519238,0.024671525064917346,239228,823,0.06976093468445618,46184,134,0,0,134,63158,0.02585533850322584,-30033,0,134,0,0.2838983050847458,0,7068,0,392,157,0,7617,6676,0.04841239522556135,366589,127361,
232,0.02010968921389397,17,76,156,325,25288,16151,519238,0.024671525064917346,239228,823,0.06976093468445618,46184,13,2,1,16,63158,0.02585533850322584,-30033,0,11,10,0.010326418143761758,11,7068,1,392,157,10,7617,6676,0.04841239522556135,366589,127361,
232,0.01896551724137931,17,76,156,325,25288,16151,519238,0.024671525064917346,239228,823,0.06976093468445618,46184,288,1,1,290,63158,0.02585533850322584,-30033,0,287,10,0.047397311645248574,11,7068,1,392,157,10,7617,6676,0.04841239522556135,366589,127361,
232,0.0,17,76,156,325,25288,16151,519238,0.024671525064917346,239228,823,0.06976093468445618,46184,2,2,0,4,63158,0.02585533850322584,-30033,0,0,0,2.737101409607226E-4,0,7068,0,392,157,0,7617,6676,0.04841239522556135,366589,127361,
232,0.0,17,76,156,325,25288,16151,519238,0.024671525064917346,239228,823,0.06976093468445618,46184,270,0,0,270,63158,0.02585533850322584,-30033,0,270,0,0.06095649021571764,0,7068,0,392,157,0,7617,6676,0.04841239522556135,366589,127361,
232,0.0,17,76,156,325,25288,16151,519238,0.024671525064917346,239228,823,0.06976093468445618,46184,270,0,0,270,63158,0.02585533850322584,-30033,0,270,0,0.06095649021571764,0,7068,0,392,157,0,7617,6676,0.04841239522556135,366589,127361,
232,0.0,17,76,156,325,25288,16151,519238,0.024671525064917346,239228,823,0.06976093468445618,46184,270,0,0,270,63158,0.02585533850322584,-30033,0,270,0,0.06095649021571764,0,7068,0,392,157,0,7617,6676,0.04841239522556135,366589,127361,
232,0.0016629711751662971,17,76,156,325,25288,16151,519238,0.024671525064917346,239228,823,0.06976093468445618,46184,144,3,0,147,63158,0.02585533850322584,-30033,1,141,2,0.04221434828701712,3,7068,0,392,157,1,7617,6676,0.04841239522556135,366589,127361,
232,0.08198664081017022,17,76,156,325,25288,16151,519238,0.024671525064917346,239228,823,0.06976093468445618,46184,565,26,4,595,63158,0.02585533850322584,-30033,3,539,20,0.04441453662149935,23,7068,0,392,157,17,7617,6676,0.04841239522556135,366589,127361,
232,0.08198664081017022,17,76,156,325,25288,16151,519238,0.024671525064917346,239228,823,0.06976093468445618,46184,565,26,4,595,63158,0.02585533850322584,-30033,3,539,20,0.04441453662149935,23,7068,0,392,157,17,7617,6676,0.04841239522556135,366589,127361,
232,0.09695956369822462,17,76,156,325,25288,16151,519238,0.024671525064917346,239228,823,0.06976093468445618,46184,593,27,12,632,63158,0.02585533850322584,-30033,16,566,37,0.04219516186065722,57,7068,4,392,157,21,7617,6676,0.04841239522556135,366589,127361,
232,0.09695956369822462,17,76,156,325,25288,16151,519238,0.024671525064917346,239228,823,0.06976093468445618,46184,593,27,12,632,63158,0.02585533850322584,-30033,16,566,37,0.04219516186065722,57,7068,4,392,157,21,7617,6676,0.04841239522556135,366589,127361,
232,0.09695956369822462,17,76,156,325,25288,16151,519238,0.024671525064917346,239228,823,0.06976093468445618,46184,593,27,12,632,63158,0.02585533850322584,-30033,16,566,37,0.04219516186065722,57,7068,4,392,157,21,7617,6676,0.04841239522556135,366589,127361,
232,0.09695956369822462,17,76,156,325,25288,16151,519238,0.024671525064917346,239228,823,0.06976093468445618,46184,593,27,12,632,63158,0.02585533850322584,-30033,16,566,37,0.04219516186065722,57,7068,4,392,157,21,7617,6676,0.04841239522556135,366589,127361,
232,0.0034423407917383822,17,76,156,325,25288,16151,519238,0.024671525064917346,239228,823,0.06976093468445618,46184,1626,73,23,1722,63158,0.02585533850322584,-30033,1,1553,1,0.02461451398406299,2,7068,0,392,157,0,7617,6676,0.04841239522556135,366589,127361,
232,0.0034423407917383822,17,76,156,325,25288,16151,519238,0.024671525064917346,239228,823,0.06976093468445618,46184,1626,73,23,1722,63158,0.02585533850322584,-30033,1,1553,1,0.02461451398406299,2,7068,0,392,157,0,7617,6676,0.04841239522556135,366589,127361,
232,0.0034423407917383822,17,76,156,325,25288,16151,519238,0.024671525064917346,239228,823,0.06976093468445618,46184,1626,73,23,1722,63158,0.02585533850322584,-30033,1,1553,1,0.02461451398406299,2,7068,0,392,157,0,7617,6676,0.04841239522556135,366589,127361,
232,0.0034423407917383822,17,76,156,325,25288,16151,519238,0.024671525064917346,239228,823,0.06976093468445618,46184,1626,73,23,1722,63158,0.02585533850322584,-30033,1,1553,1,0.02461451398406299,2,7068,0,392,157,0,7617,6676,0.04841239522556135,366589,127361,
232,0.077,17,76,156,325,25288,16151,519238,0.024671525064917346,239228,823,0.06976093468445618,46184,1648,138,105,1891,63158,0.02585533850322584,-30033,14,1510,59,0.04252312534143594,77,7068,4,392,157,45,7617,6676,0.04841239522556135,366589,127361,
232,0.077,17,76,156,325,25288,16151,519238,0.024671525064917346,239228,823,0.06976093468445618,46184,1648,138,105,1891,63158,0.02585533850322584,-30033,14,1510,59,0.04252312534143594,77,7068,4,392,157,45,7617,6676,0.04841239522556135,366589,127361,
232,0.077,17,76,156,325,25288,16151,519238,0.024671525064917346,239228,823,0.06976093468445618,46184,1648,138,105,1891,63158,0.02585533850322584,-30033,14,1510,59,0.04252312534143594,77,7068,4,392,157,45,7617,6676,0.04841239522556135,366589,127361,
232,0.077,17,76,156,325,25288,16151,519238,0.024671525064917346,239228,823,0.06976093468445618,46184,1648,138,105,1891,63158,0.02585533850322584,-30033,14,1510,59,0.04252312534143594,77,7068,4,392,157,45,7617,6676,0.04841239522556135,366589,127361,
232,0.077,17,76,156,325,25288,16151,519238,0.024671525064917346,239228,823,0.06976093468445618,46184,1648,138,105,1891,63158,0.02585533850322584,-30033,14,1510,59,0.04252312534143594,77,7068,4,392,157,45,7617,6676,0.04841239522556135,366589,127361,
232,0.077,17,76,156,325,25288,16151,519238,0.024671525064917346,239228,823,0.06976093468445618,46184,1648,138,105,1891,63158,0.02585533850322584,-30033,14,1510,59,0.04252312534143594,77,7068,4,392,157,45,7617,6676,0.04841239522556135,366589,127361,
232,0.077,17,76,156,325,25288,16151,519238,0.024671525064917346,239228,823,0.06976093468445618,46184,1648,138,105,1891,63158,0.02585533850322584,-30033,14,1510,59,0.04252312534143594,77,7068,4,392,157,45,7617,6676,0.04841239522556135,366589,127361,
232,0.077,17,76,156,325,25288,16151,519238,0.024671525064917346,239228,823,0.06976093468445618,46184,1648,138,105,1891,63158,0.02585533850322584,-30033,14,1510,59,0.04252312534143594,77,7068,4,392,157,45,7617,6676,0.04841239522556135,366589,127361,
232,0.077,17,76,156,325,25288,16151,519238,0.024671525064917346,239228,823,0.06976093468445618,46184,1648,138,105,1891,63158,0.02585533850322584,-30033,14,1510,59,0.04252312534143594,77,7068,4,392,157,45,7617,6676,0.04841239522556135,366589,127361,
232,0.077,17,76,156,325,25288,16151,519238,0.024671525064917346,239228,823,0.06976093468445618,46184,1648,138,105,1891,63158,0.02585533850322584,-30033,14,1510,59,0.04252312534143594,77,7068,4,392,157,45,7617,6676,0.04841239522556135,366589,127361,
232,0.077,17,76,156,325,25288,16151,519238,0.024671525064917346,239228,823,0.06976093468445618,46184,1648,138,105,1891,63158,0.02585533850322584,-30033,14,1510,59,0.04252312534143594,77,7068,4,392,157,45,7617,6676,0.04841239522556135,366589,127361,
232,0.077,17,76,156,325,25288,16151,519238,0.024671525064917346,239228,823,0.06976093468445618,46184,1648,138,105,1891,63158,0.02585533850322584,-30033,14,1510,59,0.04252312534143594,77,7068,4,392,157,45,7617,6676,0.04841239522556135,366589,127361,
232,0.077,17,76,156,325,25288,16151,519238,0.024671525064917346,239228,823,0.06976093468445618,46184,1648,138,105,1891,63158,0.02585533850322584,-30033,14,1510,59,0.04252312534143594,77,7068,4,392,157,45,7617,6676,0.04841239522556135,366589,127361,
232,0.077,17,76,156,325,25288,16151,519238,0.024671525064917346,239228,823,0.06976093468445618,46184,1648,138,105,1891,63158,0.02585533850322584,-30033,14,1510,59,0.04252312534143594,77,7068,4,392,157,45,7617,6676,0.04841239522556135,366589,127361,
232,0.077,17,76,156,325,25288,16151,519238,0.024671525064917346,239228,823,0.06976093468445618,46184,1648,138,105,1891,63158,0.02585533850322584,-30033,14,1510,59,0.04252312534143594,77,7068,4,392,157,45,7617,6676,0.04841239522556135,366589,127361,
232,0.077,17,76,156,325,25288,16151,519238,0.024671525064917346,239228,823,0.06976093468445618,46184,1648,138,105,1891,63158,0.02585533850322584,-30033,14,1510,59,0.04252312534143594,77,7068,4,392,157,45,7617,6676,0.04841239522556135,366589,127361,
232,0.077,17,76,156,325,25288,16151,519238,0.024671525064917346,239228,823,0.06976093468445618,46184,1648,138,105,1891,63158,0.02585533850322584,-30033,14,1510,59,0.04252312534143594,77,7068,4,392,157,45,7617,6676,0.04841239522556135,366589,127361,
232,0.077,17,76,156,325,25288,16151,519238,0.024671525064917346,239228,823,0.06976093468445618,46184,1648,138,105,1891,63158,0.02585533850322584,-30033,14,1510,59,0.04252312534143594,77,7068,4,392,157,45,7617,6676,0.04841239522556135,366589,127361,
232,0.077,17,76,156,325,25288,16151,519238,0.024671525064917346,239228,823,0.06976093468445618,46184,1648,138,105,1891,63158,0.02585533850322584,-30033,14,1510,59,0.04252312534143594,77,7068,4,392,157,45,7617,6676,0.04841239522556135,366589,127361,
232,0.077,17,76,156,325,25288,16151,519238,0.024671525064917346,239228,823,0.06976093468445618,46184,1648,138,105,1891,63158,0.02585533850322584,-30033,14,1510,59,0.04252312534143594,77,7068,4,392,157,45,7617,6676,0.04841239522556135,366589,127361,
232,0.077,17,76,156,325,25288,16151,519238,0.024671525064917346,239228,823,0.06976093468445618,46184,1648,138,105,1891,63158,0.02585533850322584,-30033,14,1510,59,0.04252312534143594,77,7068,4,392,157,45,7617,6676,0.04841239522556135,366589,127361,
232,0.077,17,76,156,325,25288,16151,519238,0.024671525064917346,239228,823,0.06976093468445618,46184,1648,138,105,1891,63158,0.02585533850322584,-30033,14,1510,59,0.04252312534143594,77,7068,4,392,157,45,7617,6676,0.04841239522556135,366589,127361,
232,0.077,17,76,156,325,25288,16151,519238,0.024671525064917346,239228,823,0.06976093468445618,46184,1648,138,105,1891,63158,0.02585533850322584,-30033,14,1510,59,0.04252312534143594,77,7068,4,392,157,45,7617,6676,0.04841239522556135,366589,127361,
232,0.077,17,76,156,325,25288,16151,519238,0.024671525064917346,239228,823,0.06976093468445618,46184,1648,138,105,1891,63158,0.02585533850322584,-30033,14,1510,59,0.04252312534143594,77,7068,4,392,157,45,7617,6676,0.04841239522556135,366589,127361,
232,0.077,17,76,156,325,25288,16151,519238,0.024671525064917346,239228,823,0.06976093468445618,46184,1648,138,105,1891,63158,0.02585533850322584,-30033,14,1510,59,0.04252312534143594,77,7068,4,392,157,45,7617,6676,0.04841239522556135,366589,127361,
232,0.077,17,76,156,325,25288,16151,519238,0.024671525064917346,239228,823,0.06976093468445618,46184,1648,138,105,1891,63158,0.02585533850322584,-30033,14,1510,59,0.04252312534143594,77,7068,4,392,157,45,7617,6676,0.04841239522556135,366589,127361,
232,0.077,17,76,156,325,25288,16151,519238,0.024671525064917346,239228,823,0.06976093468445618,46184,1648,138,105,1891,63158,0.02585533850322584,-30033,14,1510,59,0.04252312534143594,77,7068,4,392,157,45,7617,6676,0.04841239522556135,366589,127361,
232,0.077,17,76,156,325,25288,16151,519238,0.024671525064917346,239228,823,0.06976093468445618,46184,1648,138,105,1891,63158,0.02585533850322584,-30033,14,1510,59,0.04252312534143594,77,7068,4,392,157,45,7617,6676,0.04841239522556135,366589,127361,
232,0.077,17,76,156,325,25288,16151,519238,0.024671525064917346,239228,823,0.06976093468445618,46184,1648,138,105,1891,63158,0.02585533850322584,-30033,14,1510,59,0.04252312534143594,77,7068,4,392,157,45,7617,6676,0.04841239522556135,366589,127361,
232,0.077,17,76,156,325,25288,16151,519238,0.024671525064917346,239228,823,0.06976093468445618,46184,1648,138,105,1891,63158,0.02585533850322584,-30033,14,1510,59,0.04252312534143594,77,7068,4,392,157,45,7617,6676,0.04841239522556135,366589,127361,
232,0.077,17,76,156,325,25288,16151,519238,0.024671525064917346,239228,823,0.06976093468445618,46184,1648,138,105,1891,63158,0.02585533850322584,-30033,14,1510,59,0.04252312534143594,77,7068,4,392,157,45,7617,6676,0.04841239522556135,366589,127361,
232,0.077,17,76,156,325,25288,16151,519238,0.024671525064917346,239228,823,0.06976093468445618,46184,1648,138,105,1891,63158,0.02585533850322584,-30033,14,1510,59,0.04252312534143594,77,7068,4,392,157,45,7617,6676,0.04841239522556135,366589,127361,
232,0.0,17,76,156,325,25288,16151,519238,0.024671525064917346,239228,823,0.06976093468445618,46184,115,2,0,117,63158,0.02585533850322584,-30033,0,113,0,0.002685850143161239,0,7068,0,392,157,0,7617,6676,0.04841239522556135,366589,127361,
232,0.0,17,76,156,325,25288,16151,519238,0.024671525064917346,239228,823,0.06976093468445618,46184,328,0,0,328,63158,0.02585533850322584,-30033,0,328,0,0.01725702204520578,0,7068,0,392,157,0,7617,6676,0.04841239522556135,366589,127361,
232,0.0,17,76,156,325,25288,16151,519238,0.024671525064917346,239228,823,0.06976093468445618,46184,328,0,0,328,63158,0.02585533850322584,-30033,0,328,0,0.01725702204520578,0,7068,0,392,157,0,7617,6676,0.04841239522556135,366589,127361,
256,0.18101123728678226,8,78,178,342,25288,16151,519238,0.04057495933342292,239228,823,0.06976093468445618,46184,2738,144,29,2911,63158,0.02585533850322584,-30033,12,2594,39,0.11128269373097241,55,10299,4,584,145,27,11028,9715,0.04855766046133507,366589,127361,
256,0.18101123728678226,8,78,178,342,25288,16151,519238,0.04057495933342292,239228,823,0.06976093468445618,46184,2738,144,29,2911,63158,0.02585533850322584,-30033,12,2594,39,0.11128269373097241,55,10299,4,584,145,27,11028,9715,0.04855766046133507,366589,127361,
256,0.18101123728678226,8,78,178,342,25288,16151,519238,0.04057495933342292,239228,823,0.06976093468445618,46184,2738,144,29,2911,63158,0.02585533850322584,-30033,12,2594,39,0.11128269373097241,55,10299,4,584,145,27,11028,9715,0.04855766046133507,366589,127361,
256,0.14482455135439895,8,78,178,342,25288,16151,519238,0.04057495933342292,239228,823,0.06976093468445618,46184,1511,66,82,1659,63158,0.02585533850322584,-30033,10,1445,34,0.08255475366013719,44,10299,0,584,145,24,11028,9715,0.04855766046133507,366589,127361,
256,0.14482455135439895,8,78,178,342,25288,16151,519238,0.04057495933342292,239228,823,0.06976093468445618,46184,1511,66,82,1659,63158,0.02585533850322584,-30033,10,1445,34,0.08255475366013719,44,10299,0,584,145,24,11028,9715,0.04855766046133507,366589,127361,
256,0.14482455135439895,8,78,178,342,25288,16151,519238,0.04057495933342292,239228,823,0.06976093468445618,46184,1511,66,82,1659,63158,0.02585533850322584,-30033,10,1445,34,0.08255475366013719,44,10299,0,584,145,24,11028,9715,0.04855766046133507,366589,127361,
256,0.14482455135439895,8,78,178,342,25288,16151,519238,0.04057495933342292,239228,823,0.06976093468445618,46184,1511,66,82,1659,63158,0.02585533850322584,-30033,10,1445,34,0.08255475366013719,44,10299,0,584,145,24,11028,9715,0.04855766046133507,366589,127361,
256,0.14482455135439895,8,78,178,342,25288,16151,519238,0.04057495933342292,239228,823,0.06976093468445618,46184,1511,66,82,1659,63158,0.02585533850322584,-30033,10,1445,34,0.08255475366013719,44,10299,0,584,145,24,11028,9715,0.04855766046133507,366589,127361,
256,0.14482455135439895,8,78,178,342,25288,16151,519238,0.04057495933342292,239228,823,0.06976093468445618,46184,1511,66,82,1659,63158,0.02585533850322584,-30033,10,1445,34,0.08255475366013719,44,10299,0,584,145,24,11028,9715,0.04855766046133507,366589,127361,
256,0.14482455135439895,8,78,178,342,25288,16151,519238,0.04057495933342292,239228,823,0.06976093468445618,46184,1511,66,82,1659,63158,0.02585533850322584,-30033,10,1445,34,0.08255475366013719,44,10299,0,584,145,24,11028,9715,0.04855766046133507,366589,127361,
256,0.0,8,78,178,342,25288,16151,519238,0.04057495933342292,239228,823,0.06976093468445618,46184,743,47,25,815,63158,0.02585533850322584,-30033,0,696,0,0.008236912934718935,0,10299,0,584,145,0,11028,9715,0.04855766046133507,366589,127361,
256,0.011627906976744186,8,78,178,342,25288,16151,519238,0.04057495933342292,239228,823,0.06976093468445618,46184,412,34,0,446,63158,0.02585533850322584,-30033,3,378,8,0.008316733016528402,11,10299,0,584,145,5,11028,9715,0.04855766046133507,366589,127361,
256,0.0,8,78,178,342,25288,16151,519238,0.04057495933342292,239228,823,0.06976093468445618,46184,129,1,0,130,63158,0.02585533850322584,-30033,0,128,0,0.002305487176033733,0,10299,0,584,145,0,11028,9715,0.04855766046133507,366589,127361,
256,0.0,8,78,178,342,25288,16151,519238,0.04057495933342292,239228,823,0.06976093468445618,46184,284,1,0,285,63158,0.02585533850322584,-30033,0,283,0,0.06986732002556419,0,10299,0,584,145,0,11028,9715,0.04855766046133507,366589,127361,
256,0.0,8,78,178,342,25288,16151,519238,0.04057495933342292,239228,823,0.06976093468445618,46184,116,0,0,116,63158,0.02585533850322584,-30033,0,116,0,0.031406926406926404,0,10299,0,584,145,0,11028,9715,0.04855766046133507,366589,127361,
256,0.0,8,78,178,342,25288,16151,519238,0.04057495933342292,239228,823,0.06976093468445618,46184,116,0,0,116,63158,0.02585533850322584,-30033,0,116,0,0.02832222859580226,0,10299,0,584,145,0,11028,9715,0.04855766046133507,366589,127361,
256,0.0,8,78,178,342,25288,16151,519238,0.04057495933342292,239228,823,0.06976093468445618,46184,116,0,0,116,63158,0.02585533850322584,-30033,0,116,0,0.02578352235102807,0,10299,0,584,145,0,11028,9715,0.04855766046133507,366589,127361,
256,0.03225806451612903,8,78,178,342,25288,16151,519238,0.04057495933342292,239228,823,0.06976093468445618,46184,164,8,0,172,63158,0.02585533850322584,-30033,4,156,48,0.010708011899429087,52,10299,0,584,145,44,11028,9715,0.04855766046133507,366589,127361,
256,0.03225806451612903,8,78,178,342,25288,16151,519238,0.04057495933342292,239228,823,0.06976093468445618,46184,164,8,0,172,63158,0.02585533850322584,-30033,4,156,48,0.010708011899429087,52,10299,0,584,145,44,11028,9715,0.04855766046133507,366589,127361,
256,0.03225806451612903,8,78,178,342,25288,16151,519238,0.04057495933342292,239228,823,0.06976093468445618,46184,164,8,0,172,63158,0.02585533850322584,-30033,4,156,48,0.010708011899429087,52,10299,0,584,145,44,11028,9715,0.04855766046133507,366589,127361,
72,0.0896551724137931,2,15,57,89,25288,16151,519238,0.009672398137509575,239228,823,0.06976093468445618,46184,249,13,51,313,63158,0.02585533850322584,-30033,0,236,11,0.018834108103567213,13,5591,2,236,132,11,5959,5355,0.008314961790173983,366589,127361,
72,0.0,2,15,57,89,25288,16151,519238,0.009672398137509575,239228,823,0.06976093468445618,46184,235,82,3,320,63158,0.02585533850322584,-30033,0,153,0,0.008000360151725942,0,5591,0,236,132,0,5959,5355,0.008314961790173983,366589,127361,
72,0.0,2,15,57,89,25288,16151,519238,0.009672398137509575,239228,823,0.06976093468445618,46184,95,4,0,99,63158,0.02585533850322584,-30033,0,91,0,0.0028222527762750533,0,5591,0,236,132,0,5959,5355,0.008314961790173983,366589,127361,
10,0.3333333333333333,0,5,5,15,25288,16151,519238,0.11311011161086122,239228,823,0.06976093468445618,46184,665,11,0,676,63158,0.02585533850322584,-30033,3,654,8,0.07706781382815245,11,763,0,13,43,5,819,750,0.052007426493314045,366589,127361,
4,0.007735098670962546,0,4,0,8,25288,16151,519238,0.0019337746677406365,239228,823,0.06976093468445618,46184,149,8,1,158,63158,0.02585533850322584,-30033,4,141,4,0.00819276524349873,8,297,0,8,1,0,306,289,0.00312268999212809,366589,127361,
184,0.005874113725447616,19,87,97,290,25288,16151,519238,0.06929911271080039,239228,823,0.06976093468445618,46184,431,4,0,435,63158,0.02585533850322584,-30033,3,427,10,0.008916175552078999,13,6878,0,617,206,7,7701,6261,0.06441152192789004,366589,127361,
184,0.005874113725447616,19,87,97,290,25288,16151,519238,0.06929911271080039,239228,823,0.06976093468445618,46184,431,4,0,435,63158,0.02585533850322584,-30033,3,427,10,0.008916175552078999,13,6878,0,617,206,7,7701,6261,0.06441152192789004,366589,127361,
184,0.005874113725447616,19,87,97,290,25288,16151,519238,0.06929911271080039,239228,823,0.06976093468445618,46184,431,4,0,435,63158,0.02585533850322584,-30033,3,427,10,0.008916175552078999,13,6878,0,617,206,7,7701,6261,0.06441152192789004,366589,127361,
184,0.005874113725447616,19,87,97,290,25288,16151,519238,0.06929911271080039,239228,823,0.06976093468445618,46184,431,4,0,435,63158,0.02585533850322584,-30033,3,427,10,0.008916175552078999,13,6878,0,617,206,7,7701,6261,0.06441152192789004,366589,127361,
184,0.75,19,87,97,290,25288,16151,519238,0.06929911271080039,239228,823,0.06976093468445618,46184,143,7,0,150,63158,0.02585533850322584,-30033,3,136,39,0.1528487843694978,42,6878,0,617,206,36,7701,6261,0.06441152192789004,366589,127361,
184,0.007907232874733687,19,87,97,290,25288,16151,519238,0.06929911271080039,239228,823,0.06976093468445618,46184,241,15,4,260,63158,0.02585533850322584,-30033,8,226,6,0.10353935592360658,18,6878,4,617,206,-2,7701,6261,0.06441152192789004,366589,127361,
184,0.007677543186180422,19,87,97,290,25288,16151,519238,0.06929911271080039,239228,823,0.06976093468445618,46184,877,11,2,890,63158,0.02585533850322584,-30033,0,866,8,0.09940704365784869,8,6878,0,617,206,8,7701,6261,0.06441152192789004,366589,127361,
184,0.0,19,87,97,290,25288,16151,519238,0.06929911271080039,239228,823,0.06976093468445618,46184,40,0,0,40,63158,0.02585533850322584,-30033,0,40,0,0.0022419011321600717,0,6878,0,617,206,0,7701,6261,0.06441152192789004,366589,127361,
184,0.26881720430107525,19,87,97,290,25288,16151,519238,0.06929911271080039,239228,823,0.06976093468445618,46184,103,2,0,105,63158,0.02585533850322584,-30033,1,101,24,0.0917676559015097,25,6878,0,617,206,23,7701,6261,0.06441152192789004,366589,127361,
184,0.0,19,87,97,290,25288,16151,519238,0.06929911271080039,239228,823,0.06976093468445618,46184,116,0,0,116,63158,0.02585533850322584,-30033,0,116,0,0.026987140674500434,0,6878,0,617,206,0,7701,6261,0.06441152192789004,366589,127361,
184,0.002575991756826378,19,87,97,290,25288,16151,519238,0.06929911271080039,239228,823,0.06976093468445618,46184,783,19,93,895,63158,0.02585533850322584,-30033,2,764,3,0.1049547720750802,5,6878,0,617,206,1,7701,6261,0.06441152192789004,366589,127361,
184,0.002575991756826378,19,87,97,290,25288,16151,519238,0.06929911271080039,239228,823,0.06976093468445618,46184,783,19,93,895,63158,0.02585533850322584,-30033,2,764,3,0.1049547720750802,5,6878,0,617,206,1,7701,6261,0.06441152192789004,366589,127361,
184,0.002575991756826378,19,87,97,290,25288,16151,519238,0.06929911271080039,239228,823,0.06976093468445618,46184,783,19,93,895,63158,0.02585533850322584,-30033,2,764,3,0.1049547720750802,5,6878,0,617,206,1,7701,6261,0.06441152192789004,366589,127361,
184,0.0,19,87,97,290,25288,16151,519238,0.06929911271080039,239228,823,0.06976093468445618,46184,72,17,9,98,63158,0.02585533850322584,-30033,0,55,0,0.013589659193795579,0,6878,0,617,206,0,7701,6261,0.06441152192789004,366589,127361,
184,0.0,19,87,97,290,25288,16151,519238,0.06929911271080039,239228,823,0.06976093468445618,46184,72,17,9,98,63158,0.02585533850322584,-30033,0,55,0,0.013589659193795579,0,6878,0,617,206,0,7701,6261,0.06441152192789004,366589,127361,
184,0.06881949745120075,19,87,97,290,25288,16151,519238,0.06929911271080039,239228,823,0.06976093468445618,46184,1161,70,35,1266,63158,0.02585533850322584,-30033,4,1091,6,0.07911658265086713,21,6878,11,617,206,2,7701,6261,0.06441152192789004,366589,127361,
184,0.06881949745120075,19,87,97,290,25288,16151,519238,0.06929911271080039,239228,823,0.06976093468445618,46184,1161,70,35,1266,63158,0.02585533850322584,-30033,4,1091,6,0.07911658265086713,21,6878,11,617,206,2,7701,6261,0.06441152192789004,366589,127361,
184,0.06881949745120075,19,87,97,290,25288,16151,519238,0.06929911271080039,239228,823,0.06976093468445618,46184,1161,70,35,1266,63158,0.02585533850322584,-30033,4,1091,6,0.07911658265086713,21,6878,11,617,206,2,7701,6261,0.06441152192789004,366589,127361,
184,0.06881949745120075,19,87,97,290,25288,16151,519238,0.06929911271080039,239228,823,0.06976093468445618,46184,1161,70,35,1266,63158,0.02585533850322584,-30033,4,1091,6,0.07911658265086713,21,6878,11,617,206,2,7701,6261,0.06441152192789004,366589,127361,
184,0.05759162303664921,19,87,97,290,25288,16151,519238,0.06929911271080039,239228,823,0.06976093468445618,46184,618,58,29,705,63158,0.02585533850322584,-30033,1,560,10,0.03734079444096609,11,6878,0,617,206,9,7701,6261,0.06441152192789004,366589,127361,
184,0.05759162303664921,19,87,97,290,25288,16151,519238,0.06929911271080039,239228,823,0.06976093468445618,46184,618,58,29,705,63158,0.02585533850322584,-30033,1,560,10,0.03734079444096609,11,6878,0,617,206,9,7701,6261,0.06441152192789004,366589,127361,
184,0.05759162303664921,19,87,97,290,25288,16151,519238,0.06929911271080039,239228,823,0.06976093468445618,46184,618,58,29,705,63158,0.02585533850322584,-30033,1,560,10,0.03734079444096609,11,6878,0,617,206,9,7701,6261,0.06441152192789004,366589,127361,
184,0.05759162303664921,19,87,97,290,25288,16151,519238,0.06929911271080039,239228,823,0.06976093468445618,46184,618,58,29,705,63158,0.02585533850322584,-30033,1,560,10,0.03734079444096609,11,6878,0,617,206,9,7701,6261,0.06441152192789004,366589,127361,
184,0.05759162303664921,19,87,97,290,25288,16151,519238,0.06929911271080039,239228,823,0.06976093468445618,46184,618,58,29,705,63158,0.02585533850322584,-30033,1,560,10,0.03734079444096609,11,6878,0,617,206,9,7701,6261,0.06441152192789004,366589,127361,
184,0.0,19,87,97,290,25288,16151,519238,0.06929911271080039,239228,823,0.06976093468445618,46184,146,3,0,149,63158,0.02585533850322584,-30033,0,143,0,0.011695590162159654,0,6878,0,617,206,0,7701,6261,0.06441152192789004,366589,127361,
843,0.14770151701830603,87,3138,-2295,4068,25288,16151,519238,0.014749177556208682,239228,823,0.06976093468445618,46184,2538,454,107,3099,63158,0.02585533850322584,-30033,19,2084,183,0.11949444308010625,264,14629,62,8332,754,164,23715,6297,0.04019278744783729,366589,127361,
843,0.14770151701830603,87,3138,-2295,4068,25288,16151,519238,0.014749177556208682,239228,823,0.06976093468445618,46184,2538,454,107,3099,63158,0.02585533850322584,-30033,19,2084,183,0.11949444308010625,264,14629,62,8332,754,164,23715,6297,0.04019278744783729,366589,127361,
843,0.14770151701830603,87,3138,-2295,4068,25288,16151,519238,0.014749177556208682,239228,823,0.06976093468445618,46184,2538,454,107,3099,63158,0.02585533850322584,-30033,19,2084,183,0.11949444308010625,264,14629,62,8332,754,164,23715,6297,0.04019278744783729,366589,127361,
843,0.14770151701830603,87,3138,-2295,4068,25288,16151,519238,0.014749177556208682,239228,823,0.06976093468445618,46184,2538,454,107,3099,63158,0.02585533850322584,-30033,19,2084,183,0.11949444308010625,264,14629,62,8332,754,164,23715,6297,0.04019278744783729,366589,127361,
843,0.14770151701830603,87,3138,-2295,4068,25288,16151,519238,0.014749177556208682,239228,823,0.06976093468445618,46184,2538,454,107,3099,63158,0.02585533850322584,-30033,19,2084,183,0.11949444308010625,264,14629,62,8332,754,164,23715,6297,0.04019278744783729,366589,127361,
843,0.14770151701830603,87,3138,-2295,4068,25288,16151,519238,0.014749177556208682,239228,823,0.06976093468445618,46184,2538,454,107,3099,63158,0.02585533850322584,-30033,19,2084,183,0.11949444308010625,264,14629,62,8332,754,164,23715,6297,0.04019278744783729,366589,127361,
843,0.14770151701830603,87,3138,-2295,4068,25288,16151,519238,0.014749177556208682,239228,823,0.06976093468445618,46184,2538,454,107,3099,63158,0.02585533850322584,-30033,19,2084,183,0.11949444308010625,264,14629,62,8332,754,164,23715,6297,0.04019278744783729,366589,127361,
843,0.14770151701830603,87,3138,-2295,4068,25288,16151,519238,0.014749177556208682,239228,823,0.06976093468445618,46184,2538,454,107,3099,63158,0.02585533850322584,-30033,19,2084,183,0.11949444308010625,264,14629,62,8332,754,164,23715,6297,0.04019278744783729,366589,127361,
843,0.14770151701830603,87,3138,-2295,4068,25288,16151,519238,0.014749177556208682,239228,823,0.06976093468445618,46184,2538,454,107,3099,63158,0.02585533850322584,-30033,19,2084,183,0.11949444308010625,264,14629,62,8332,754,164,23715,6297,0.04019278744783729,366589,127361,
843,0.14770151701830603,87,3138,-2295,4068,25288,16151,519238,0.014749177556208682,239228,823,0.06976093468445618,46184,2538,454,107,3099,63158,0.02585533850322584,-30033,19,2084,183,0.11949444308010625,264,14629,62,8332,754,164,23715,6297,0.04019278744783729,366589,127361,
843,0.14770151701830603,87,3138,-2295,4068,25288,16151,519238,0.014749177556208682,239228,823,0.06976093468445618,46184,2538,454,107,3099,63158,0.02585533850322584,-30033,19,2084,183,0.11949444308010625,264,14629,62,8332,754,164,23715,6297,0.04019278744783729,366589,127361,
843,0.0979810932698979,87,3138,-2295,4068,25288,16151,519238,0.014749177556208682,239228,823,0.06976093468445618,46184,121,59,0,180,63158,0.02585533850322584,-30033,0,62,60,0.030117479620280146,60,14629,0,8332,754,60,23715,6297,0.04019278744783729,366589,127361,
843,0.0979810932698979,87,3138,-2295,4068,25288,16151,519238,0.014749177556208682,239228,823,0.06976093468445618,46184,121,59,0,180,63158,0.02585533850322584,-30033,0,62,60,0.030117479620280146,60,14629,0,8332,754,60,23715,6297,0.04019278744783729,366589,127361,
843,0.0979810932698979,87,3138,-2295,4068,25288,16151,519238,0.014749177556208682,239228,823,0.06976093468445618,46184,121,59,0,180,63158,0.02585533850322584,-30033,0,62,60,0.030117479620280146,60,14629,0,8332,754,60,23715,6297,0.04019278744783729,366589,127361,
843,0.0979810932698979,87,3138,-2295,4068,25288,16151,519238,0.014749177556208682,239228,823,0.06976093468445618,46184,121,59,0,180,63158,0.02585533850322584,-30033,0,62,60,0.030117479620280146,60,14629,0,8332,754,60,23715,6297,0.04019278744783729,366589,127361,
843,0.0979810932698979,87,3138,-2295,4068,25288,16151,519238,0.014749177556208682,239228,823,0.06976093468445618,46184,121,59,0,180,63158,0.02585533850322584,-30033,0,62,60,0.030117479620280146,60,14629,0,8332,754,60,23715,6297,0.04019278744783729,366589,127361,
843,0.0979810932698979,87,3138,-2295,4068,25288,16151,519238,0.014749177556208682,239228,823,0.06976093468445618,46184,121,59,0,180,63158,0.02585533850322584,-30033,0,62,60,0.030117479620280146,60,14629,0,8332,754,60,23715,6297,0.04019278744783729,366589,127361,
843,0.0979810932698979,87,3138,-2295,4068,25288,16151,519238,0.014749177556208682,239228,823,0.06976093468445618,46184,121,59,0,180,63158,0.02585533850322584,-30033,0,62,60,0.030117479620280146,60,14629,0,8332,754,60,23715,6297,0.04019278744783729,366589,127361,
843,0.0979810932698979,87,3138,-2295,4068,25288,16151,519238,0.014749177556208682,239228,823,0.06976093468445618,46184,121,59,0,180,63158,0.02585533850322584,-30033,0,62,60,0.030117479620280146,60,14629,0,8332,754,60,23715,6297,0.04019278744783729,366589,127361,
843,0.0979810932698979,87,3138,-2295,4068,25288,16151,519238,0.014749177556208682,239228,823,0.06976093468445618,46184,121,59,0,180,63158,0.02585533850322584,-30033,0,62,60,0.030117479620280146,60,14629,0,8332,754,60,23715,6297,0.04019278744783729,366589,127361,
843,0.0979810932698979,87,3138,-2295,4068,25288,16151,519238,0.014749177556208682,239228,823,0.06976093468445618,46184,121,59,0,180,63158,0.02585533850322584,-30033,0,62,60,0.030117479620280146,60,14629,0,8332,754,60,23715,6297,0.04019278744783729,366589,127361,
843,0.0979810932698979,87,3138,-2295,4068,25288,16151,519238,0.014749177556208682,239228,823,0.06976093468445618,46184,121,59,0,180,63158,0.02585533850322584,-30033,0,62,60,0.030117479620280146,60,14629,0,8332,754,60,23715,6297,0.04019278744783729,366589,127361,
843,0.0979810932698979,87,3138,-2295,4068,25288,16151,519238,0.014749177556208682,239228,823,0.06976093468445618,46184,121,59,0,180,63158,0.02585533850322584,-30033,0,62,60,0.030117479620280146,60,14629,0,8332,754,60,23715,6297,0.04019278744783729,366589,127361,
843,0.0979810932698979,87,3138,-2295,4068,25288,16151,519238,0.014749177556208682,239228,823,0.06976093468445618,46184,121,59,0,180,63158,0.02585533850322584,-30033,0,62,60,0.030117479620280146,60,14629,0,8332,754,60,23715,6297,0.04019278744783729,366589,127361,
843,0.0979810932698979,87,3138,-2295,4068,25288,16151,519238,0.014749177556208682,239228,823,0.06976093468445618,46184,121,59,0,180,63158,0.02585533850322584,-30033,0,62,60,0.030117479620280146,60,14629,0,8332,754,60,23715,6297,0.04019278744783729,366589,127361,
843,0.0979810932698979,87,3138,-2295,4068,25288,16151,519238,0.014749177556208682,239228,823,0.06976093468445618,46184,121,59,0,180,63158,0.02585533850322584,-30033,0,62,60,0.030117479620280146,60,14629,0,8332,754,60,23715,6297,0.04019278744783729,366589,127361,
843,0.0979810932698979,87,3138,-2295,4068,25288,16151,519238,0.014749177556208682,239228,823,0.06976093468445618,46184,121,59,0,180,63158,0.02585533850322584,-30033,0,62,60,0.030117479620280146,60,14629,0,8332,754,60,23715,6297,0.04019278744783729,366589,127361,
843,0.0979810932698979,87,3138,-2295,4068,25288,16151,519238,0.014749177556208682,239228,823,0.06976093468445618,46184,121,59,0,180,63158,0.02585533850322584,-30033,0,62,60,0.030117479620280146,60,14629,0,8332,754,60,23715,6297,0.04019278744783729,366589,127361,
843,0.0979810932698979,87,3138,-2295,4068,25288,16151,519238,0.014749177556208682,239228,823,0.06976093468445618,46184,121,59,0,180,63158,0.02585533850322584,-30033,0,62,60,0.030117479620280146,60,14629,0,8332,754,60,23715,6297,0.04019278744783729,366589,127361,
843,0.0979810932698979,87,3138,-2295,4068,25288,16151,519238,0.014749177556208682,239228,823,0.06976093468445618,46184,121,59,0,180,63158,0.02585533850322584,-30033,0,62,60,0.030117479620280146,60,14629,0,8332,754,60,23715,6297,0.04019278744783729,366589,127361,
843,0.0979810932698979,87,3138,-2295,4068,25288,16151,519238,0.014749177556208682,239228,823,0.06976093468445618,46184,121,59,0,180,63158,0.02585533850322584,-30033,0,62,60,0.030117479620280146,60,14629,0,8332,754,60,23715,6297,0.04019278744783729,366589,127361,
843,0.0,87,3138,-2295,4068,25288,16151,519238,0.014749177556208682,239228,823,0.06976093468445618,46184,5,4,0,9,63158,0.02585533850322584,-30033,0,1,0,0.0028983461615277074,0,14629,0,8332,754,0,23715,6297,0.04019278744783729,366589,127361,
843,0.006644518272425249,87,3138,-2295,4068,25288,16151,519238,0.014749177556208682,239228,823,0.06976093468445618,46184,215,1,0,216,63158,0.02585533850322584,-30033,1,214,1,0.115835403195098,2,14629,0,8332,754,0,23715,6297,0.04019278744783729,366589,127361,
843,0.0017857142857142857,87,3138,-2295,4068,25288,16151,519238,0.014749177556208682,239228,823,0.06976093468445618,46184,6,1,0,7,63158,0.02585533850322584,-30033,0,5,1,0.0012999192957848617,1,14629,0,8332,754,1,23715,6297,0.04019278744783729,366589,127361,
843,0.018696534085898227,87,3138,-2295,4068,25288,16151,519238,0.014749177556208682,239228,823,0.06976093468445618,46184,324,424,1,749,63158,0.02585533850322584,-30033,424,-100,0,0.15085744989102307,424,14629,0,8332,754,-424,23715,6297,0.04019278744783729,366589,127361,
843,0.011812733431772778,87,3138,-2295,4068,25288,16151,519238,0.014749177556208682,239228,823,0.06976093468445618,46184,279,278,0,557,63158,0.02585533850322584,-30033,272,1,0,0.06544405101920661,272,14629,0,8332,754,-272,23715,6297,0.04019278744783729,366589,127361,
843,0.011812733431772778,87,3138,-2295,4068,25288,16151,519238,0.014749177556208682,239228,823,0.06976093468445618,46184,279,278,0,557,63158,0.02585533850322584,-30033,272,1,0,0.06544405101920661,272,14629,0,8332,754,-272,23715,6297,0.04019278744783729,366589,127361,
843,0.06222222222222222,87,3138,-2295,4068,25288,16151,519238,0.014749177556208682,239228,823,0.06976093468445618,46184,263,160,69,492,63158,0.02585533850322584,-30033,0,103,14,0.06782151129143531,14,14629,0,8332,754,14,23715,6297,0.04019278744783729,366589,127361,
843,0.06222222222222222,87,3138,-2295,4068,25288,16151,519238,0.014749177556208682,239228,823,0.06976093468445618,46184,263,160,69,492,63158,0.02585533850322584,-30033,0,103,14,0.06782151129143531,14,14629,0,8332,754,14,23715,6297,0.04019278744783729,366589,127361,
843,0.06222222222222222,87,3138,-2295,4068,25288,16151,519238,0.014749177556208682,239228,823,0.06976093468445618,46184,263,160,69,492,63158,0.02585533850322584,-30033,0,103,14,0.06782151129143531,14,14629,0,8332,754,14,23715,6297,0.04019278744783729,366589,127361,
843,0.0017006802721088435,87,3138,-2295,4068,25288,16151,519238,0.014749177556208682,239228,823,0.06976093468445618,46184,190,12,0,202,63158,0.02585533850322584,-30033,0,178,1,0.046361632144983414,1,14629,0,8332,754,1,23715,6297,0.04019278744783729,366589,127361,
843,0.012908849410592728,87,3138,-2295,4068,25288,16151,519238,0.014749177556208682,239228,823,0.06976093468445618,46184,222,419,15,656,63158,0.02585533850322584,-30033,311,-197,0,0.11285613054201465,311,14629,0,8332,754,-311,23715,6297,0.04019278744783729,366589,127361,
843,0.012908849410592728,87,3138,-2295,4068,25288,16151,519238,0.014749177556208682,239228,823,0.06976093468445618,46184,222,419,15,656,63158,0.02585533850322584,-30033,311,-197,0,0.11285613054201465,311,14629,0,8332,754,-311,23715,6297,0.04019278744783729,366589,127361,
843,0.0054488098652136505,87,3138,-2295,4068,25288,16151,519238,0.014749177556208682,239228,823,0.06976093468445618,46184,223,221,12,456,63158,0.02585533850322584,-30033,133,2,0,0.2177929067204265,133,14629,0,8332,754,-133,23715,6297,0.04019278744783729,366589,127361,
843,0.0054488098652136505,87,3138,-2295,4068,25288,16151,519238,0.014749177556208682,239228,823,0.06976093468445618,46184,223,221,12,456,63158,0.02585533850322584,-30033,133,2,0,0.2177929067204265,133,14629,0,8332,754,-133,23715,6297,0.04019278744783729,366589,127361,
843,0.0054488098652136505,87,3138,-2295,4068,25288,16151,519238,0.014749177556208682,239228,823,0.06976093468445618,46184,223,221,12,456,63158,0.02585533850322584,-30033,133,2,0,0.2177929067204265,133,14629,0,8332,754,-133,23715,6297,0.04019278744783729,366589,127361,
843,0.10183239099208102,87,3138,-2295,4068,25288,16151,519238,0.014749177556208682,239228,823,0.06976093468445618,46184,871,655,75,1601,63158,0.02585533850322584,-30033,24,216,101,0.06968512381982266,139,14629,14,8332,754,77,23715,6297,0.04019278744783729,366589,127361,
843,0.10183239099208102,87,3138,-2295,4068,25288,16151,519238,0.014749177556208682,239228,823,0.06976093468445618,46184,871,655,75,1601,63158,0.02585533850322584,-30033,24,216,101,0.06968512381982266,139,14629,14,8332,754,77,23715,6297,0.04019278744783729,366589,127361,
843,0.014263074484944533,87,3138,-2295,4068,25288,16151,519238,0.014749177556208682,239228,823,0.06976093468445618,46184,251,61,1,313,63158,0.02585533850322584,-30033,3,190,6,0.00721279405787561,9,14629,0,8332,754,3,23715,6297,0.04019278744783729,366589,127361,
843,0.0015082956259426848,87,3138,-2295,4068,25288,16151,519238,0.014749177556208682,239228,823,0.06976093468445618,46184,419,48,0,467,63158,0.02585533850322584,-30033,0,371,1,0.014080284110995897,1,14629,0,8332,754,1,23715,6297,0.04019278744783729,366589,127361,
843,0.0015082956259426848,87,3138,-2295,4068,25288,16151,519238,0.014749177556208682,239228,823,0.06976093468445618,46184,419,48,0,467,63158,0.02585533850322584,-30033,0,371,1,0.014080284110995897,1,14629,0,8332,754,1,23715,6297,0.04019278744783729,366589,127361,
843,0.0015082956259426848,87,3138,-2295,4068,25288,16151,519238,0.014749177556208682,239228,823,0.06976093468445618,46184,419,48,0,467,63158,0.02585533850322584,-30033,0,371,1,0.014080284110995897,1,14629,0,8332,754,1,23715,6297,0.04019278744783729,366589,127361,
843,0.0015082956259426848,87,3138,-2295,4068,25288,16151,519238,0.014749177556208682,239228,823,0.06976093468445618,46184,419,48,0,467,63158,0.02585533850322584,-30033,0,371,1,0.014080284110995897,1,14629,0,8332,754,1,23715,6297,0.04019278744783729,366589,127361,
843,0.0015082956259426848,87,3138,-2295,4068,25288,16151,519238,0.014749177556208682,239228,823,0.06976093468445618,46184,419,48,0,467,63158,0.02585533850322584,-30033,0,371,1,0.014080284110995897,1,14629,0,8332,754,1,23715,6297,0.04019278744783729,366589,127361,
843,0.032906424822342704,87,3138,-2295,4068,25288,16151,519238,0.014749177556208682,239228,823,0.06976093468445618,46184,139,0,0,139,63158,0.02585533850322584,-30033,0,139,139,0.032906424822342704,139,14629,0,8332,754,139,23715,6297,0.04019278744783729,366589,127361,
843,0.0013908205841446453,87,3138,-2295,4068,25288,16151,519238,0.014749177556208682,239228,823,0.06976093468445618,46184,121,7,0,128,63158,0.02585533850322584,-30033,0,114,1,0.002279693722877153,1,14629,0,8332,754,1,23715,6297,0.04019278744783729,366589,127361,
843,0.0,87,3138,-2295,4068,25288,16151,519238,0.014749177556208682,239228,823,0.06976093468445618,46184,2,1,0,3,63158,0.02585533850322584,-30033,0,1,0,3.0429049599350845E-4,0,14629,0,8332,754,0,23715,6297,0.04019278744783729,366589,127361,
843,0.06643356643356643,87,3138,-2295,4068,25288,16151,519238,0.014749177556208682,239228,823,0.06976093468445618,46184,621,14,0,635,63158,0.02585533850322584,-30033,0,607,19,0.015774683461873256,19,14629,0,8332,754,19,23715,6297,0.04019278744783729,366589,127361,
843,0.06643356643356643,87,3138,-2295,4068,25288,16151,519238,0.014749177556208682,239228,823,0.06976093468445618,46184,621,14,0,635,63158,0.02585533850322584,-30033,0,607,19,0.015774683461873256,19,14629,0,8332,754,19,23715,6297,0.04019278744783729,366589,127361,
843,0.0013386880856760374,87,3138,-2295,4068,25288,16151,519238,0.014749177556208682,239228,823,0.06976093468445618,46184,649,42,2,693,63158,0.02585533850322584,-30033,0,607,1,0.024446905040206194,1,14629,0,8332,754,1,23715,6297,0.04019278744783729,366589,127361,
843,0.0013386880856760374,87,3138,-2295,4068,25288,16151,519238,0.014749177556208682,239228,823,0.06976093468445618,46184,649,42,2,693,63158,0.02585533850322584,-30033,0,607,1,0.024446905040206194,1,14629,0,8332,754,1,23715,6297,0.04019278744783729,366589,127361,
843,0.0013386880856760374,87,3138,-2295,4068,25288,16151,519238,0.014749177556208682,239228,823,0.06976093468445618,46184,649,42,2,693,63158,0.02585533850322584,-30033,0,607,1,0.024446905040206194,1,14629,0,8332,754,1,23715,6297,0.04019278744783729,366589,127361,
843,0.0013386880856760374,87,3138,-2295,4068,25288,16151,519238,0.014749177556208682,239228,823,0.06976093468445618,46184,649,42,2,693,63158,0.02585533850322584,-30033,0,607,1,0.024446905040206194,1,14629,0,8332,754,1,23715,6297,0.04019278744783729,366589,127361,
843,0.0013386880856760374,87,3138,-2295,4068,25288,16151,519238,0.014749177556208682,239228,823,0.06976093468445618,46184,649,42,2,693,63158,0.02585533850322584,-30033,0,607,1,0.024446905040206194,1,14629,0,8332,754,1,23715,6297,0.04019278744783729,366589,127361,
843,0.0013386880856760374,87,3138,-2295,4068,25288,16151,519238,0.014749177556208682,239228,823,0.06976093468445618,46184,649,42,2,693,63158,0.02585533850322584,-30033,0,607,1,0.024446905040206194,1,14629,0,8332,754,1,23715,6297,0.04019278744783729,366589,127361,
843,0.0013386880856760374,87,3138,-2295,4068,25288,16151,519238,0.014749177556208682,239228,823,0.06976093468445618,46184,649,42,2,693,63158,0.02585533850322584,-30033,0,607,1,0.024446905040206194,1,14629,0,8332,754,1,23715,6297,0.04019278744783729,366589,127361,
843,0.0013386880856760374,87,3138,-2295,4068,25288,16151,519238,0.014749177556208682,239228,823,0.06976093468445618,46184,649,42,2,693,63158,0.02585533850322584,-30033,0,607,1,0.024446905040206194,1,14629,0,8332,754,1,23715,6297,0.04019278744783729,366589,127361,
843,0.0013386880856760374,87,3138,-2295,4068,25288,16151,519238,0.014749177556208682,239228,823,0.06976093468445618,46184,649,42,2,693,63158,0.02585533850322584,-30033,0,607,1,0.024446905040206194,1,14629,0,8332,754,1,23715,6297,0.04019278744783729,366589,127361,
843,0.0013386880856760374,87,3138,-2295,4068,25288,16151,519238,0.014749177556208682,239228,823,0.06976093468445618,46184,649,42,2,693,63158,0.02585533850322584,-30033,0,607,1,0.024446905040206194,1,14629,0,8332,754,1,23715,6297,0.04019278744783729,366589,127361,
843,0.0013386880856760374,87,3138,-2295,4068,25288,16151,519238,0.014749177556208682,239228,823,0.06976093468445618,46184,649,42,2,693,63158,0.02585533850322584,-30033,0,607,1,0.024446905040206194,1,14629,0,8332,754,1,23715,6297,0.04019278744783729,366589,127361,
843,0.0012903225806451613,87,3138,-2295,4068,25288,16151,519238,0.014749177556208682,239228,823,0.06976093468445618,46184,108,8,0,116,63158,0.02585533850322584,-30033,0,100,1,0.0023204479906651972,1,14629,0,8332,754,1,23715,6297,0.04019278744783729,366589,127361,
843,0.0,87,3138,-2295,4068,25288,16151,519238,0.014749177556208682,239228,823,0.06976093468445618,46184,6,13,0,19,63158,0.02585533850322584,-30033,0,-7,0,0.0023274219785855265,0,14629,0,8332,754,0,23715,6297,0.04019278744783729,366589,127361,
843,0.01602001602001602,87,3138,-2295,4068,25288,16151,519238,0.014749177556208682,239228,823,0.06976093468445618,46184,325,33,2,360,63158,0.02585533850322584,-30033,2,292,13,0.021974793126286654,15,14629,0,8332,754,11,23715,6297,0.04019278744783729,366589,127361,
843,0.01602001602001602,87,3138,-2295,4068,25288,16151,519238,0.014749177556208682,239228,823,0.06976093468445618,46184,325,33,2,360,63158,0.02585533850322584,-30033,2,292,13,0.021974793126286654,15,14629,0,8332,754,11,23715,6297,0.04019278744783729,366589,127361,
129,0.13738390092879257,11,73,56,213,25288,16151,519238,0.03323711683243723,239228,823,0.06976093468445618,46184,11,48,2,61,63158,0.02585533850322584,-30033,9,-37,4,0.05217259394684687,13,2374,0,529,29,-5,2932,1845,0.02689723788639382,366589,127361,
129,0.07689581856839121,11,73,56,213,25288,16151,519238,0.03323711683243723,239228,823,0.06976093468445618,46184,22,81,5,108,63158,0.02585533850322584,-30033,9,-59,4,0.03694027209607449,13,2374,0,529,29,-5,2932,1845,0.02689723788639382,366589,127361,
129,0.14574423889934263,11,73,56,213,25288,16151,519238,0.03323711683243723,239228,823,0.06976093468445618,46184,75,10,2,87,63158,0.02585533850322584,-30033,10,65,75,0.14574423889934263,87,2374,2,529,29,65,2932,1845,0.02689723788639382,366589,127361,
129,0.14574423889934263,11,73,56,213,25288,16151,519238,0.03323711683243723,239228,823,0.06976093468445618,46184,75,10,2,87,63158,0.02585533850322584,-30033,10,65,75,0.14574423889934263,87,2374,2,529,29,65,2932,1845,0.02689723788639382,366589,127361,
129,0.14574423889934263,11,73,56,213,25288,16151,519238,0.03323711683243723,239228,823,0.06976093468445618,46184,75,10,2,87,63158,0.02585533850322584,-30033,10,65,75,0.14574423889934263,87,2374,2,529,29,65,2932,1845,0.02689723788639382,366589,127361,
129,0.03274966612257012,11,73,56,213,25288,16151,519238,0.03323711683243723,239228,823,0.06976093468445618,46184,5,11,5,21,63158,0.02585533850322584,-30033,11,-6,5,0.03274966612257012,21,2374,5,529,29,-6,2932,1845,0.02689723788639382,366589,127361,
129,0.03274966612257012,11,73,56,213,25288,16151,519238,0.03323711683243723,239228,823,0.06976093468445618,46184,5,11,5,21,63158,0.02585533850322584,-30033,11,-6,5,0.03274966612257012,21,2374,5,529,29,-6,2932,1845,0.02689723788639382,366589,127361,
129,0.012232415902140673,11,73,56,213,25288,16151,519238,0.03323711683243723,239228,823,0.06976093468445618,46184,764,63,8,835,63158,0.02585533850322584,-30033,2,701,2,0.023336863121151245,4,2374,0,529,29,0,2932,1845,0.02689723788639382,366589,127361,
129,0.012232415902140673,11,73,56,213,25288,16151,519238,0.03323711683243723,239228,823,0.06976093468445618,46184,764,63,8,835,63158,0.02585533850322584,-30033,2,701,2,0.023336863121151245,4,2374,0,529,29,0,2932,1845,0.02689723788639382,366589,127361,
129,0.012232415902140673,11,73,56,213,25288,16151,519238,0.03323711683243723,239228,823,0.06976093468445618,46184,764,63,8,835,63158,0.02585533850322584,-30033,2,701,2,0.023336863121151245,4,2374,0,529,29,0,2932,1845,0.02689723788639382,366589,127361,
129,0.012232415902140673,11,73,56,213,25288,16151,519238,0.03323711683243723,239228,823,0.06976093468445618,46184,764,63,8,835,63158,0.02585533850322584,-30033,2,701,2,0.023336863121151245,4,2374,0,529,29,0,2932,1845,0.02689723788639382,366589,127361,
129,0.012232415902140673,11,73,56,213,25288,16151,519238,0.03323711683243723,239228,823,0.06976093468445618,46184,764,63,8,835,63158,0.02585533850322584,-30033,2,701,2,0.023336863121151245,4,2374,0,529,29,0,2932,1845,0.02689723788639382,366589,127361,
129,0.012232415902140673,11,73,56,213,25288,16151,519238,0.03323711683243723,239228,823,0.06976093468445618,46184,764,63,8,835,63158,0.02585533850322584,-30033,2,701,2,0.023336863121151245,4,2374,0,529,29,0,2932,1845,0.02689723788639382,366589,127361,
129,0.009602194787379973,11,73,56,213,25288,16151,519238,0.03323711683243723,239228,823,0.06976093468445618,46184,204,6,0,210,63158,0.02585533850322584,-30033,6,198,8,0.006565248163297534,14,2374,0,529,29,2,2932,1845,0.02689723788639382,366589,127361,
2,0.0,0,1,1,3,25288,16151,519238,0.0014534883720930232,239228,823,0.06976093468445618,46184,363,42,12,417,63158,0.02585533850322584,-30033,0,321,0,0.01644608038919977,0,780,0,86,39,0,905,694,0.009638249830631091,366589,127361,
2,0.0,0,1,1,3,25288,16151,519238,0.0014534883720930232,239228,823,0.06976093468445618,46184,363,42,12,417,63158,0.02585533850322584,-30033,0,321,0,0.01644608038919977,0,780,0,86,39,0,905,694,0.009638249830631091,366589,127361,
2,0.00872093023255814,0,1,1,3,25288,16151,519238,0.0014534883720930232,239228,823,0.06976093468445618,46184,153,4,0,157,63158,0.02585533850322584,-30033,1,149,2,0.008786823156688816,3,780,0,86,39,1,905,694,0.009638249830631091,366589,127361,
2,0.0,0,1,1,3,25288,16151,519238,0.0014534883720930232,239228,823,0.06976093468445618,46184,91,3,0,94,63158,0.02585533850322584,-30033,0,88,0,0.0038913966932974495,0,780,0,86,39,0,905,694,0.009638249830631091,366589,127361,
2,0.0,0,5,-3,7,25288,16151,519238,0.002123298901459256,239228,823,0.06976093468445618,46184,42,0,0,42,63158,0.02585533850322584,-30033,0,42,0,0.026802807913209957,0,1404,0,173,16,0,1593,1231,0.11542260997690883,366589,127361,
2,0.0,0,5,-3,7,25288,16151,519238,0.002123298901459256,239228,823,0.06976093468445618,46184,60,39,0,99,63158,0.02585533850322584,-30033,0,21,0,0.06790318659408365,0,1404,0,173,16,0,1593,1231,0.11542260997690883,366589,127361,
2,0.0,0,5,-3,7,25288,16151,519238,0.002123298901459256,239228,823,0.06976093468445618,46184,60,39,0,99,63158,0.02585533850322584,-30033,0,21,0,0.06790318659408365,0,1404,0,173,16,0,1593,1231,0.11542260997690883,366589,127361,
2,0.0,0,5,-3,7,25288,16151,519238,0.002123298901459256,239228,823,0.06976093468445618,46184,401,7,0,408,63158,0.02585533850322584,-30033,0,394,0,0.17720507393015353,0,1404,0,173,16,0,1593,1231,0.11542260997690883,366589,127361,
2,0.013157894736842105,0,5,-3,7,25288,16151,519238,0.002123298901459256,239228,823,0.06976093468445618,46184,459,76,13,548,63158,0.02585533850322584,-30033,3,383,0,0.10541554409564156,3,1404,0,173,16,-3,1593,1231,0.11542260997690883,366589,127361,
2,0.013157894736842105,0,5,-3,7,25288,16151,519238,0.002123298901459256,239228,823,0.06976093468445618,46184,459,76,13,548,63158,0.02585533850322584,-30033,3,383,0,0.10541554409564156,3,1404,0,173,16,-3,1593,1231,0.11542260997690883,366589,127361,
11,0.17624521072796934,8,27,-16,46,25288,16151,519238,0.022030651340996167,239228,823,0.06976093468445618,46184,178,27,8,213,63158,0.02585533850322584,-30033,27,151,11,0.15335698036398465,46,406,8,33,8,-16,447,373,0.046848764039246024,366589,127361,
11,0.0,0,11,0,22,25288,16151,519238,0.002305752047330017,239228,823,0.06976093468445618,46184,15,3,0,18,63158,0.02585533850322584,-30033,0,12,0,0.0024871305756617628,0,917,0,348,110,0,1375,569,0.02128270841872767,366589,127361,
11,0.010403120936280884,0,11,0,22,25288,16151,519238,0.002305752047330017,239228,823,0.06976093468445618,46184,214,56,18,288,63158,0.02585533850322584,-30033,11,158,5,0.009872258367165715,16,917,0,348,110,-6,1375,569,0.02128270841872767,366589,127361,
11,0.010403120936280884,0,11,0,22,25288,16151,519238,0.002305752047330017,239228,823,0.06976093468445618,46184,214,56,18,288,63158,0.02585533850322584,-30033,11,158,5,0.009872258367165715,16,917,0,348,110,-6,1375,569,0.02128270841872767,366589,127361,
11,0.010403120936280884,0,11,0,22,25288,16151,519238,0.002305752047330017,239228,823,0.06976093468445618,46184,214,56,18,288,63158,0.02585533850322584,-30033,11,158,5,0.009872258367165715,16,917,0,348,110,-6,1375,569,0.02128270841872767,366589,127361,
37,0.005392613283674737,0,900,-863,937,25288,16151,519238,0.04562157433165004,239228,823,0.06976093468445618,46184,223,171,0,394,63158,0.02585533850322584,-30033,139,52,0,0.016983626458157562,139,958,0,1000,37,-139,1995,-42,0.0374242058918758,366589,127361,
37,0.005392613283674737,0,900,-863,937,25288,16151,519238,0.04562157433165004,239228,823,0.06976093468445618,46184,223,171,0,394,63158,0.02585533850322584,-30033,139,52,0,0.016983626458157562,139,958,0,1000,37,-139,1995,-42,0.0374242058918758,366589,127361,
1,0.0,0,1,0,2,25288,16151,519238,5.827505827505828E-4,239228,823,0.06976093468445618,46184,96,0,0,96,63158,0.02585533850322584,-30033,0,96,0,0.001095665274258714,0,1187,0,94,5,0,1286,1093,0.030661127753308818,366589,127361,
1,0.006993006993006993,0,1,0,2,25288,16151,519238,5.827505827505828E-4,239228,823,0.06976093468445618,46184,331,61,5,397,63158,0.02585533850322584,-30033,1,270,1,0.03663259456228956,2,1187,0,94,5,0,1286,1093,0.030661127753308818,366589,127361,
1,0.006993006993006993,0,1,0,2,25288,16151,519238,5.827505827505828E-4,239228,823,0.06976093468445618,46184,331,61,5,397,63158,0.02585533850322584,-30033,1,270,1,0.03663259456228956,2,1187,0,94,5,0,1286,1093,0.030661127753308818,366589,127361,
1,0.006993006993006993,0,1,0,2,25288,16151,519238,5.827505827505828E-4,239228,823,0.06976093468445618,46184,331,61,5,397,63158,0.02585533850322584,-30033,1,270,1,0.03663259456228956,2,1187,0,94,5,0,1286,1093,0.030661127753308818,366589,127361,
1,0.0,0,1,0,2,25288,16151,519238,5.827505827505828E-4,239228,823,0.06976093468445618,46184,121,31,0,152,63158,0.02585533850322584,-30033,0,90,0,0.004368247583397709,0,1187,0,94,5,0,1286,1093,0.030661127753308818,366589,127361,
1,0.0,0,1,0,2,25288,16151,519238,5.827505827505828E-4,239228,823,0.06976093468445618,46184,112,0,0,112,63158,0.02585533850322584,-30033,0,112,0,0.003034434412191229,0,1187,0,94,5,0,1286,1093,0.030661127753308818,366589,127361,
1,0.0,0,1,0,2,25288,16151,519238,5.827505827505828E-4,239228,823,0.06976093468445618,46184,112,0,0,112,63158,0.02585533850322584,-30033,0,112,0,0.003034434412191229,0,1187,0,94,5,0,1286,1093,0.030661127753308818,366589,127361,
28,0.0,0,16,12,44,25288,16151,519238,0.010065278933203463,239228,823,0.06976093468445618,46184,387,15,5,407,63158,0.02585533850322584,-30033,0,372,0,0.14484278650288346,0,4699,0,1082,64,0,5845,3617,0.07533443191714893,366589,127361,
28,0.0,0,16,12,44,25288,16151,519238,0.010065278933203463,239228,823,0.06976093468445618,46184,387,15,5,407,63158,0.02585533850322584,-30033,0,372,0,0.14484278650288346,0,4699,0,1082,64,0,5845,3617,0.07533443191714893,366589,127361,
28,0.0,0,16,12,44,25288,16151,519238,0.010065278933203463,239228,823,0.06976093468445618,46184,387,15,5,407,63158,0.02585533850322584,-30033,0,372,0,0.14484278650288346,0,4699,0,1082,64,0,5845,3617,0.07533443191714893,366589,127361,
28,0.0,0,16,12,44,25288,16151,519238,0.010065278933203463,239228,823,0.06976093468445618,46184,387,15,5,407,63158,0.02585533850322584,-30033,0,372,0,0.14484278650288346,0,4699,0,1082,64,0,5845,3617,0.07533443191714893,366589,127361,
28,0.0,0,16,12,44,25288,16151,519238,0.010065278933203463,239228,823,0.06976093468445618,46184,387,15,5,407,63158,0.02585533850322584,-30033,0,372,0,0.14484278650288346,0,4699,0,1082,64,0,5845,3617,0.07533443191714893,366589,127361,
28,0.0,0,16,12,44,25288,16151,519238,0.010065278933203463,239228,823,0.06976093468445618,46184,637,338,0,975,63158,0.02585533850322584,-30033,0,299,0,0.12425283326797096,0,4699,0,1082,64,0,5845,3617,0.07533443191714893,366589,127361,
28,0.0,0,16,12,44,25288,16151,519238,0.010065278933203463,239228,823,0.06976093468445618,46184,637,338,0,975,63158,0.02585533850322584,-30033,0,299,0,0.12425283326797096,0,4699,0,1082,64,0,5845,3617,0.07533443191714893,366589,127361,
28,0.0,0,16,12,44,25288,16151,519238,0.010065278933203463,239228,823,0.06976093468445618,46184,637,338,0,975,63158,0.02585533850322584,-30033,0,299,0,0.12425283326797096,0,4699,0,1082,64,0,5845,3617,0.07533443191714893,366589,127361,
28,0.0,0,16,12,44,25288,16151,519238,0.010065278933203463,239228,823,0.06976093468445618,46184,637,338,0,975,63158,0.02585533850322584,-30033,0,299,0,0.12425283326797096,0,4699,0,1082,64,0,5845,3617,0.07533443191714893,366589,127361,
28,0.0,0,16,12,44,25288,16151,519238,0.010065278933203463,239228,823,0.06976093468445618,46184,637,338,0,975,63158,0.02585533850322584,-30033,0,299,0,0.12425283326797096,0,4699,0,1082,64,0,5845,3617,0.07533443191714893,366589,127361,
28,0.0,0,16,12,44,25288,16151,519238,0.010065278933203463,239228,823,0.06976093468445618,46184,637,338,0,975,63158,0.02585533850322584,-30033,0,299,0,0.12425283326797096,0,4699,0,1082,64,0,5845,3617,0.07533443191714893,366589,127361,
28,0.0,0,16,12,44,25288,16151,519238,0.010065278933203463,239228,823,0.06976093468445618,46184,637,338,0,975,63158,0.02585533850322584,-30033,0,299,0,0.12425283326797096,0,4699,0,1082,64,0,5845,3617,0.07533443191714893,366589,127361,
28,0.0,0,16,12,44,25288,16151,519238,0.010065278933203463,239228,823,0.06976093468445618,46184,637,338,0,975,63158,0.02585533850322584,-30033,0,299,0,0.12425283326797096,0,4699,0,1082,64,0,5845,3617,0.07533443191714893,366589,127361,
28,0.0,0,16,12,44,25288,16151,519238,0.010065278933203463,239228,823,0.06976093468445618,46184,272,131,0,403,63158,0.02585533850322584,-30033,0,141,0,0.12717033542740017,0,4699,0,1082,64,0,5845,3617,0.07533443191714893,366589,127361,
28,0.0,0,16,12,44,25288,16151,519238,0.010065278933203463,239228,823,0.06976093468445618,46184,272,131,0,403,63158,0.02585533850322584,-30033,0,141,0,0.12717033542740017,0,4699,0,1082,64,0,5845,3617,0.07533443191714893,366589,127361,
28,0.0,0,16,12,44,25288,16151,519238,0.010065278933203463,239228,823,0.06976093468445618,46184,208,84,16,308,63158,0.02585533850322584,-30033,0,124,0,0.04808535907119161,0,4699,0,1082,64,0,5845,3617,0.07533443191714893,366589,127361,
28,0.0,0,16,12,44,25288,16151,519238,0.010065278933203463,239228,823,0.06976093468445618,46184,315,283,0,598,63158,0.02585533850322584,-30033,0,32,0,0.062388899359809215,0,4699,0,1082,64,0,5845,3617,0.07533443191714893,366589,127361,
28,0.0,0,16,12,44,25288,16151,519238,0.010065278933203463,239228,823,0.06976093468445618,46184,315,283,0,598,63158,0.02585533850322584,-30033,0,32,0,0.062388899359809215,0,4699,0,1082,64,0,5845,3617,0.07533443191714893,366589,127361,
28,0.0,0,16,12,44,25288,16151,519238,0.010065278933203463,239228,823,0.06976093468445618,46184,315,283,0,598,63158,0.02585533850322584,-30033,0,32,0,0.062388899359809215,0,4699,0,1082,64,0,5845,3617,0.07533443191714893,366589,127361,
28,0.0,0,16,12,44,25288,16151,519238,0.010065278933203463,239228,823,0.06976093468445618,46184,315,283,0,598,63158,0.02585533850322584,-30033,0,32,0,0.062388899359809215,0,4699,0,1082,64,0,5845,3617,0.07533443191714893,366589,127361,
28,0.0,0,16,12,44,25288,16151,519238,0.010065278933203463,239228,823,0.06976093468445618,46184,315,283,0,598,63158,0.02585533850322584,-30033,0,32,0,0.062388899359809215,0,4699,0,1082,64,0,5845,3617,0.07533443191714893,366589,127361,
28,0.0,0,16,12,44,25288,16151,519238,0.010065278933203463,239228,823,0.06976093468445618,46184,315,283,0,598,63158,0.02585533850322584,-30033,0,32,0,0.062388899359809215,0,4699,0,1082,64,0,5845,3617,0.07533443191714893,366589,127361,
28,0.0,0,16,12,44,25288,16151,519238,0.010065278933203463,239228,823,0.06976093468445618,46184,315,283,0,598,63158,0.02585533850322584,-30033,0,32,0,0.062388899359809215,0,4699,0,1082,64,0,5845,3617,0.07533443191714893,366589,127361,
28,0.0,0,16,12,44,25288,16151,519238,0.010065278933203463,239228,823,0.06976093468445618,46184,315,283,0,598,63158,0.02585533850322584,-30033,0,32,0,0.062388899359809215,0,4699,0,1082,64,0,5845,3617,0.07533443191714893,366589,127361,
28,0.0,0,16,12,44,25288,16151,519238,0.010065278933203463,239228,823,0.06976093468445618,46184,315,283,0,598,63158,0.02585533850322584,-30033,0,32,0,0.062388899359809215,0,4699,0,1082,64,0,5845,3617,0.07533443191714893,366589,127361,
28,0.0,0,16,12,44,25288,16151,519238,0.010065278933203463,239228,823,0.06976093468445618,46184,315,283,0,598,63158,0.02585533850322584,-30033,0,32,0,0.062388899359809215,0,4699,0,1082,64,0,5845,3617,0.07533443191714893,366589,127361,
28,0.0,0,16,12,44,25288,16151,519238,0.010065278933203463,239228,823,0.06976093468445618,46184,315,283,0,598,63158,0.02585533850322584,-30033,0,32,0,0.062388899359809215,0,4699,0,1082,64,0,5845,3617,0.07533443191714893,366589,127361,
28,0.0,0,16,12,44,25288,16151,519238,0.010065278933203463,239228,823,0.06976093468445618,46184,315,283,0,598,63158,0.02585533850322584,-30033,0,32,0,0.062388899359809215,0,4699,0,1082,64,0,5845,3617,0.07533443191714893,366589,127361,
28,0.0,0,16,12,44,25288,16151,519238,0.010065278933203463,239228,823,0.06976093468445618,46184,315,283,0,598,63158,0.02585533850322584,-30033,0,32,0,0.062388899359809215,0,4699,0,1082,64,0,5845,3617,0.07533443191714893,366589,127361,
28,0.0,0,16,12,44,25288,16151,519238,0.010065278933203463,239228,823,0.06976093468445618,46184,315,283,0,598,63158,0.02585533850322584,-30033,0,32,0,0.062388899359809215,0,4699,0,1082,64,0,5845,3617,0.07533443191714893,366589,127361,
28,0.0,0,16,12,44,25288,16151,519238,0.010065278933203463,239228,823,0.06976093468445618,46184,251,3,0,254,63158,0.02585533850322584,-30033,0,248,0,0.037799968794331194,0,4699,0,1082,64,0,5845,3617,0.07533443191714893,366589,127361,
28,0.0,0,16,12,44,25288,16151,519238,0.010065278933203463,239228,823,0.06976093468445618,46184,251,3,0,254,63158,0.02585533850322584,-30033,0,248,0,0.037799968794331194,0,4699,0,1082,64,0,5845,3617,0.07533443191714893,366589,127361,
28,0.0,0,16,12,44,25288,16151,519238,0.010065278933203463,239228,823,0.06976093468445618,46184,251,3,0,254,63158,0.02585533850322584,-30033,0,248,0,0.037799968794331194,0,4699,0,1082,64,0,5845,3617,0.07533443191714893,366589,127361,
28,0.0,0,16,12,44,25288,16151,519238,0.010065278933203463,239228,823,0.06976093468445618,46184,184,1,0,185,63158,0.02585533850322584,-30033,0,183,0,0.015214666528192889,0,4699,0,1082,64,0,5845,3617,0.07533443191714893,366589,127361,
10,0.007874015748031496,0,8,2,18,25288,16151,519238,0.006369990268070423,239228,823,0.06976093468445618,46184,212,9,0,221,63158,0.02585533850322584,-30033,6,203,6,0.004419005011408682,12,442,0,17,0,0,459,425,0.03877188107127663,366589,127361,
10,0.007874015748031496,0,8,2,18,25288,16151,519238,0.006369990268070423,239228,823,0.06976093468445618,46184,212,9,0,221,63158,0.02585533850322584,-30033,6,203,6,0.004419005011408682,12,442,0,17,0,0,459,425,0.03877188107127663,366589,127361,
160,0.12225274725274725,5,721,-561,886,25288,16151,519238,0.03262023826086363,239228,823,0.06976093468445618,46184,3,8,0,11,63158,0.02585533850322584,-30033,8,-5,3,0.12225274725274725,11,5414,0,2711,179,-5,8304,2703,0.02860297403617319,366589,127361,
160,0.002574002574002574,5,721,-561,886,25288,16151,519238,0.03262023826086363,239228,823,0.06976093468445618,46184,145,5,0,150,63158,0.02585533850322584,-30033,2,140,2,0.015550810639787952,4,5414,0,2711,179,0,8304,2703,0.02860297403617319,366589,127361,
160,0.002574002574002574,5,721,-561,886,25288,16151,519238,0.03262023826086363,239228,823,0.06976093468445618,46184,145,5,0,150,63158,0.02585533850322584,-30033,2,140,2,0.015550810639787952,4,5414,0,2711,179,0,8304,2703,0.02860297403617319,366589,127361,
160,0.009696969696969697,5,721,-561,886,25288,16151,519238,0.03262023826086363,239228,823,0.06976093468445618,46184,91,6,0,97,63158,0.02585533850322584,-30033,6,85,2,0.0074321421703709215,8,5414,0,2711,179,-4,8304,2703,0.02860297403617319,366589,127361,
160,0.0012698412698412698,5,721,-561,886,25288,16151,519238,0.03262023826086363,239228,823,0.06976093468445618,46184,237,40,0,277,63158,0.02585533850322584,-30033,1,197,1,0.006894705722627514,2,5414,0,2711,179,0,8304,2703,0.02860297403617319,366589,127361,
160,0.010773247049306909,5,721,-561,886,25288,16151,519238,0.03262023826086363,239228,823,0.06976093468445618,46184,76,321,0,397,63158,0.02585533850322584,-30033,293,-245,0,0.036664820395844996,293,5414,0,2711,179,-293,8304,2703,0.02860297403617319,366589,127361,
160,0.0031101353823637027,5,721,-561,886,25288,16151,519238,0.03262023826086363,239228,823,0.06976093468445618,46184,3,92,0,95,63158,0.02585533850322584,-30033,85,-89,0,0.0022742801266556123,85,5414,0,2711,179,-85,8304,2703,0.02860297403617319,366589,127361,
160,0.0,5,721,-561,886,25288,16151,519238,0.03262023826086363,239228,823,0.06976093468445618,46184,181,27,0,208,63158,0.02585533850322584,-30033,0,154,0,0.003473712158865731,0,5414,0,2711,179,0,8304,2703,0.02860297403617319,366589,127361,
160,0.0,5,721,-561,886,25288,16151,519238,0.03262023826086363,239228,823,0.06976093468445618,46184,181,27,0,208,63158,0.02585533850322584,-30033,0,154,0,0.003473712158865731,0,5414,0,2711,179,0,8304,2703,0.02860297403617319,366589,127361,
160,0.0,5,721,-561,886,25288,16151,519238,0.03262023826086363,239228,823,0.06976093468445618,46184,181,27,0,208,63158,0.02585533850322584,-30033,0,154,0,0.003473712158865731,0,5414,0,2711,179,0,8304,2703,0.02860297403617319,366589,127361,
160,0.0,5,721,-561,886,25288,16151,519238,0.03262023826086363,239228,823,0.06976093468445618,46184,181,27,0,208,63158,0.02585533850322584,-30033,0,154,0,0.003473712158865731,0,5414,0,2711,179,0,8304,2703,0.02860297403617319,366589,127361,
160,0.009263800815144402,5,721,-561,886,25288,16151,519238,0.03262023826086363,239228,823,0.06976093468445618,46184,1080,664,67,1811,63158,0.02585533850322584,-30033,10,416,5,0.04185768395657286,15,5414,0,2711,179,-5,8304,2703,0.02860297403617319,366589,127361,
160,0.009263800815144402,5,721,-561,886,25288,16151,519238,0.03262023826086363,239228,823,0.06976093468445618,46184,1080,664,67,1811,63158,0.02585533850322584,-30033,10,416,5,0.04185768395657286,15,5414,0,2711,179,-5,8304,2703,0.02860297403617319,366589,127361,
160,0.009263800815144402,5,721,-561,886,25288,16151,519238,0.03262023826086363,239228,823,0.06976093468445618,46184,1080,664,67,1811,63158,0.02585533850322584,-30033,10,416,5,0.04185768395657286,15,5414,0,2711,179,-5,8304,2703,0.02860297403617319,366589,127361,
160,0.009263800815144402,5,721,-561,886,25288,16151,519238,0.03262023826086363,239228,823,0.06976093468445618,46184,1080,664,67,1811,63158,0.02585533850322584,-30033,10,416,5,0.04185768395657286,15,5414,0,2711,179,-5,8304,2703,0.02860297403617319,366589,127361,
160,0.0012531328320802004,5,721,-561,886,25288,16151,519238,0.03262023826086363,239228,823,0.06976093468445618,46184,499,80,9,588,63158,0.02585533850322584,-30033,1,419,1,0.05308337814033186,2,5414,0,2711,179,0,8304,2703,0.02860297403617319,366589,127361,
160,0.0012531328320802004,5,721,-561,886,25288,16151,519238,0.03262023826086363,239228,823,0.06976093468445618,46184,499,80,9,588,63158,0.02585533850322584,-30033,1,419,1,0.05308337814033186,2,5414,0,2711,179,0,8304,2703,0.02860297403617319,366589,127361,
160,0.0012531328320802004,5,721,-561,886,25288,16151,519238,0.03262023826086363,239228,823,0.06976093468445618,46184,499,80,9,588,63158,0.02585533850322584,-30033,1,419,1,0.05308337814033186,2,5414,0,2711,179,0,8304,2703,0.02860297403617319,366589,127361,
160,0.0012531328320802004,5,721,-561,886,25288,16151,519238,0.03262023826086363,239228,823,0.06976093468445618,46184,499,80,9,588,63158,0.02585533850322584,-30033,1,419,1,0.05308337814033186,2,5414,0,2711,179,0,8304,2703,0.02860297403617319,366589,127361,
160,0.0012531328320802004,5,721,-561,886,25288,16151,519238,0.03262023826086363,239228,823,0.06976093468445618,46184,499,80,9,588,63158,0.02585533850322584,-30033,1,419,1,0.05308337814033186,2,5414,0,2711,179,0,8304,2703,0.02860297403617319,366589,127361,
160,0.0012531328320802004,5,721,-561,886,25288,16151,519238,0.03262023826086363,239228,823,0.06976093468445618,46184,499,80,9,588,63158,0.02585533850322584,-30033,1,419,1,0.05308337814033186,2,5414,0,2711,179,0,8304,2703,0.02860297403617319,366589,127361,
160,0.0012531328320802004,5,721,-561,886,25288,16151,519238,0.03262023826086363,239228,823,0.06976093468445618,46184,499,80,9,588,63158,0.02585533850322584,-30033,1,419,1,0.05308337814033186,2,5414,0,2711,179,0,8304,2703,0.02860297403617319,366589,127361,
160,0.0012531328320802004,5,721,-561,886,25288,16151,519238,0.03262023826086363,239228,823,0.06976093468445618,46184,499,80,9,588,63158,0.02585533850322584,-30033,1,419,1,0.05308337814033186,2,5414,0,2711,179,0,8304,2703,0.02860297403617319,366589,127361,
160,0.0012531328320802004,5,721,-561,886,25288,16151,519238,0.03262023826086363,239228,823,0.06976093468445618,46184,499,80,9,588,63158,0.02585533850322584,-30033,1,419,1,0.05308337814033186,2,5414,0,2711,179,0,8304,2703,0.02860297403617319,366589,127361,
160,0.06830053364203631,5,721,-561,886,25288,16151,519238,0.03262023826086363,239228,823,0.06976093468445618,46184,7,13,4,24,63158,0.02585533850322584,-30033,10,-6,4,0.04623031048096743,18,5414,4,2711,179,-6,8304,2703,0.02860297403617319,366589,127361,
160,0.015653220951234198,5,721,-561,886,25288,16151,519238,0.03262023826086363,239228,823,0.06976093468445618,46184,30,5,0,35,63158,0.02585533850322584,-30033,0,25,26,0.03035426383437754,26,5414,0,2711,179,26,8304,2703,0.02860297403617319,366589,127361,
160,0.015653220951234198,5,721,-561,886,25288,16151,519238,0.03262023826086363,239228,823,0.06976093468445618,46184,30,5,0,35,63158,0.02585533850322584,-30033,0,25,26,0.03035426383437754,26,5414,0,2711,179,26,8304,2703,0.02860297403617319,366589,127361,
160,0.1659583723731763,5,721,-561,886,25288,16151,519238,0.03262023826086363,239228,823,0.06976093468445618,46184,35,17,1,53,63158,0.02585533850322584,-30033,5,18,33,0.08433115818175654,39,5414,1,2711,179,28,8304,2703,0.02860297403617319,366589,127361,
160,0.1659583723731763,5,721,-561,886,25288,16151,519238,0.03262023826086363,239228,823,0.06976093468445618,46184,35,17,1,53,63158,0.02585533850322584,-30033,5,18,33,0.08433115818175654,39,5414,1,2711,179,28,8304,2703,0.02860297403617319,366589,127361,
160,0.1659583723731763,5,721,-561,886,25288,16151,519238,0.03262023826086363,239228,823,0.06976093468445618,46184,35,17,1,53,63158,0.02585533850322584,-30033,5,18,33,0.08433115818175654,39,5414,1,2711,179,28,8304,2703,0.02860297403617319,366589,127361,
1,0.0,0,4,-3,5,25288,16151,519238,0.008375209380234507,239228,823,0.06976093468445618,46184,8,8,0,16,63158,0.02585533850322584,-30033,0,0,0,0.004415011037527594,0,73,0,12,0,0,85,61,0.024519048456017434,366589,127361,
1,0.0,0,4,-3,5,25288,16151,519238,0.008375209380234507,239228,823,0.06976093468445618,46184,8,8,0,16,63158,0.02585533850322584,-30033,0,0,0,0.004415011037527594,0,73,0,12,0,0,85,61,0.024519048456017434,366589,127361,
1,0.0,0,4,-3,5,25288,16151,519238,0.008375209380234507,239228,823,0.06976093468445618,46184,64,0,0,64,63158,0.02585533850322584,-30033,0,64,0,0.04401650618982118,0,73,0,12,0,0,85,61,0.024519048456017434,366589,127361,
1,0.0,0,4,-3,5,25288,16151,519238,0.008375209380234507,239228,823,0.06976093468445618,46184,64,0,0,64,63158,0.02585533850322584,-30033,0,64,0,0.04401650618982118,0,73,0,12,0,0,85,61,0.024519048456017434,366589,127361,
1,0.0,0,1,0,2,25288,16151,519238,1.6737802326554523E-4,239228,823,0.06976093468445618,46184,221,29,8,258,63158,0.02585533850322584,-30033,0,192,0,0.11843442415918796,0,1159,0,300,12,0,1471,859,0.05587405691332098,366589,127361,
1,0.0,0,1,0,2,25288,16151,519238,1.6737802326554523E-4,239228,823,0.06976093468445618,46184,338,1,0,339,63158,0.02585533850322584,-30033,0,337,0,0.13852687762353386,0,1159,0,300,12,0,1471,859,0.05587405691332098,366589,127361,
1,0.0,0,1,0,2,25288,16151,519238,1.6737802326554523E-4,239228,823,0.06976093468445618,46184,83,54,0,137,63158,0.02585533850322584,-30033,0,29,0,0.05718040484892038,0,1159,0,300,12,0,1471,859,0.05587405691332098,366589,127361,
1,0.0,0,1,0,2,25288,16151,519238,1.6737802326554523E-4,239228,823,0.06976093468445618,46184,83,54,0,137,63158,0.02585533850322584,-30033,0,29,0,0.05718040484892038,0,1159,0,300,12,0,1471,859,0.05587405691332098,366589,127361,
1,0.0,0,1,0,2,25288,16151,519238,1.6737802326554523E-4,239228,823,0.06976093468445618,46184,83,54,0,137,63158,0.02585533850322584,-30033,0,29,0,0.05718040484892038,0,1159,0,300,12,0,1471,859,0.05587405691332098,366589,127361,
1,0.0,0,1,0,2,25288,16151,519238,1.6737802326554523E-4,239228,823,0.06976093468445618,46184,138,0,0,138,63158,0.02585533850322584,-30033,0,138,0,0.01131392797416408,0,1159,0,300,12,0,1471,859,0.05587405691332098,366589,127361,
1,0.0,0,1,0,2,25288,16151,519238,1.6737802326554523E-4,239228,823,0.06976093468445618,46184,138,0,0,138,63158,0.02585533850322584,-30033,0,138,0,0.01131392797416408,0,1159,0,300,12,0,1471,859,0.05587405691332098,366589,127361,
0,0.0,0,0,0,0,25288,16151,519238,0.0,239228,823,0.06976093468445618,46184,113,1,0,114,63158,0.02585533850322584,-30033,0,112,0,0.0016246243998636796,0,165,0,4,5,0,174,161,0.023150475015865805,366589,127361,
0,0.0,0,0,0,0,25288,16151,519238,0.0,239228,823,0.06976093468445618,46184,158,3,0,161,63158,0.02585533850322584,-30033,0,155,0,0.0501990190297538,0,158,0,3,0,0,161,155,0.0501990190297538,366589,127361,
124,0.08914450035945364,0,0,124,124,25288,16151,519238,0.014857416726575605,239228,823,0.06976093468445618,46184,124,0,0,124,63158,0.02585533850322584,-30033,0,124,124,0.08914450035945364,124,722,0,158,27,124,907,564,0.04065627129087412,366589,127361,
124,0.0,0,0,124,124,25288,16151,519238,0.014857416726575605,239228,823,0.06976093468445618,46184,62,0,0,62,63158,0.02585533850322584,-30033,0,62,0,6.363020587450482E-4,0,722,0,158,27,0,907,564,0.04065627129087412,366589,127361,
124,0.0,0,0,124,124,25288,16151,519238,0.014857416726575605,239228,823,0.06976093468445618,46184,266,123,25,414,63158,0.02585533850322584,-30033,0,143,0,0.1324864290766468,0,722,0,158,27,0,907,564,0.04065627129087412,366589,127361,
611,0.41908112264513653,130,44,567,785,25288,16151,519238,0.23861167346852072,239228,823,0.06976093468445618,46184,256,15,55,326,63158,0.02585533850322584,-30033,15,241,256,0.41908112264513653,326,611,55,44,130,241,785,567,0.23861167346852072,366589,127361,
611,0.41908112264513653,130,44,567,785,25288,16151,519238,0.23861167346852072,239228,823,0.06976093468445618,46184,256,15,55,326,63158,0.02585533850322584,-30033,15,241,256,0.41908112264513653,326,611,55,44,130,241,785,567,0.23861167346852072,366589,127361,
611,0.41908112264513653,130,44,567,785,25288,16151,519238,0.23861167346852072,239228,823,0.06976093468445618,46184,256,15,55,326,63158,0.02585533850322584,-30033,15,241,256,0.41908112264513653,326,611,55,44,130,241,785,567,0.23861167346852072,366589,127361,
611,0.41908112264513653,130,44,567,785,25288,16151,519238,0.23861167346852072,239228,823,0.06976093468445618,46184,256,15,55,326,63158,0.02585533850322584,-30033,15,241,256,0.41908112264513653,326,611,55,44,130,241,785,567,0.23861167346852072,366589,127361,
611,0.22142883004970698,130,44,567,785,25288,16151,519238,0.23861167346852072,239228,823,0.06976093468445618,46184,183,17,75,275,63158,0.02585533850322584,-30033,17,166,183,0.22142883004970698,275,611,75,44,130,166,785,567,0.23861167346852072,366589,127361,
611,0.22142883004970698,130,44,567,785,25288,16151,519238,0.23861167346852072,239228,823,0.06976093468445618,46184,183,17,75,275,63158,0.02585533850322584,-30033,17,166,183,0.22142883004970698,275,611,75,44,130,166,785,567,0.23861167346852072,366589,127361,
0,0.0,0,0,0,0,25288,16151,519238,0.0,239228,823,0.06976093468445618,46184,433,1,0,434,63158,0.02585533850322584,-30033,0,432,0,0.00942981829926106,0,1103,0,2,0,0,1105,1101,0.0032369714338776026,366589,127361,
0,0.0,0,0,0,0,25288,16151,519238,0.0,239228,823,0.06976093468445618,46184,433,1,0,434,63158,0.02585533850322584,-30033,0,432,0,0.00942981829926106,0,1103,0,2,0,0,1105,1101,0.0032369714338776026,366589,127361,
0,0.0,0,0,0,0,25288,16151,519238,0.0,239228,823,0.06976093468445618,46184,433,1,0,434,63158,0.02585533850322584,-30033,0,432,0,0.00942981829926106,0,1103,0,2,0,0,1105,1101,0.0032369714338776026,366589,127361,
0,0.0,0,0,0,0,25288,16151,519238,0.0,239228,823,0.06976093468445618,46184,348,1,0,349,63158,0.02585533850322584,-30033,0,347,0,0.0024963260033431856,0,1103,0,2,0,0,1105,1101,0.0032369714338776026,366589,127361,
0,0.0,0,0,0,0,25288,16151,519238,0.0,239228,823,0.06976093468445618,46184,348,1,0,349,63158,0.02585533850322584,-30033,0,347,0,0.0024963260033431856,0,1103,0,2,0,0,1105,1101,0.0032369714338776026,366589,127361,
0,0.0,0,0,0,0,25288,16151,519238,0.0,239228,823,0.06976093468445618,46184,348,1,0,349,63158,0.02585533850322584,-30033,0,347,0,0.0024963260033431856,0,1103,0,2,0,0,1105,1101,0.0032369714338776026,366589,127361,
0,0.0,0,0,0,0,25288,16151,519238,0.0,239228,823,0.06976093468445618,46184,348,1,0,349,63158,0.02585533850322584,-30033,0,347,0,0.0024963260033431856,0,1103,0,2,0,0,1105,1101,0.0032369714338776026,366589,127361,
0,0.0,0,0,0,0,25288,16151,519238,0.0,239228,823,0.06976093468445618,46184,80,0,0,80,63158,0.02585533850322584,-30033,0,80,0,8.032128514056225E-4,0,1103,0,2,0,0,1105,1101,0.0032369714338776026,366589,127361,
0,0.0,0,0,0,0,25288,16151,519238,0.0,239228,823,0.06976093468445618,46184,134,0,0,134,63158,0.02585533850322584,-30033,0,134,0,0.003153723175000873,0,1103,0,2,0,0,1105,1101,0.0032369714338776026,366589,127361,
0,0.0,0,130,-130,130,25288,16151,519238,0.0011810022166503142,239228,823,0.06976093468445618,46184,251,5,0,256,63158,0.02585533850322584,-30033,0,246,0,0.045034612606734276,0,629,0,176,0,0,805,453,0.05813215066088421,366589,127361,
0,0.0,0,130,-130,130,25288,16151,519238,0.0011810022166503142,239228,823,0.06976093468445618,46184,251,5,0,256,63158,0.02585533850322584,-30033,0,246,0,0.045034612606734276,0,629,0,176,0,0,805,453,0.05813215066088421,366589,127361,
0,0.0,0,130,-130,130,25288,16151,519238,0.0011810022166503142,239228,823,0.06976093468445618,46184,251,5,0,256,63158,0.02585533850322584,-30033,0,246,0,0.045034612606734276,0,629,0,176,0,0,805,453,0.05813215066088421,366589,127361,
0,0.0,0,130,-130,130,25288,16151,519238,0.0011810022166503142,239228,823,0.06976093468445618,46184,251,5,0,256,63158,0.02585533850322584,-30033,0,246,0,0.045034612606734276,0,629,0,176,0,0,805,453,0.05813215066088421,366589,127361,
0,0.004724008866601257,0,130,-130,130,25288,16151,519238,0.0011810022166503142,239228,823,0.06976093468445618,46184,144,150,0,294,63158,0.02585533850322584,-30033,130,-6,0,0.002354458482948879,130,629,0,176,0,-130,805,453,0.05813215066088421,366589,127361,
1060,0.07956479775379485,48,1088,-28,2196,25288,16151,519238,0.02679842012495772,239228,823,0.06976093468445618,46184,913,38,10,961,63158,0.02585533850322584,-30033,38,875,52,0.3341401622635485,100,13906,10,3879,804,14,18589,10027,0.046977768882876636,366589,127361,
1060,0.07956479775379485,48,1088,-28,2196,25288,16151,519238,0.02679842012495772,239228,823,0.06976093468445618,46184,913,38,10,961,63158,0.02585533850322584,-30033,38,875,52,0.3341401622635485,100,13906,10,3879,804,14,18589,10027,0.046977768882876636,366589,127361,
1060,0.1775012101302369,48,1088,-28,2196,25288,16151,519238,0.02679842012495772,239228,823,0.06976093468445618,46184,4639,1277,436,6352,63158,0.02585533850322584,-30033,71,3362,416,0.1450179773142129,505,13906,18,3879,804,345,18589,10027,0.046977768882876636,366589,127361,
1060,0.1775012101302369,48,1088,-28,2196,25288,16151,519238,0.02679842012495772,239228,823,0.06976093468445618,46184,4639,1277,436,6352,63158,0.02585533850322584,-30033,71,3362,416,0.1450179773142129,505,13906,18,3879,804,345,18589,10027,0.046977768882876636,366589,127361,
1060,0.1775012101302369,48,1088,-28,2196,25288,16151,519238,0.02679842012495772,239228,823,0.06976093468445618,46184,4639,1277,436,6352,63158,0.02585533850322584,-30033,71,3362,416,0.1450179773142129,505,13906,18,3879,804,345,18589,10027,0.046977768882876636,366589,127361,
1060,0.1775012101302369,48,1088,-28,2196,25288,16151,519238,0.02679842012495772,239228,823,0.06976093468445618,46184,4639,1277,436,6352,63158,0.02585533850322584,-30033,71,3362,416,0.1450179773142129,505,13906,18,3879,804,345,18589,10027,0.046977768882876636,366589,127361,
1060,0.1775012101302369,48,1088,-28,2196,25288,16151,519238,0.02679842012495772,239228,823,0.06976093468445618,46184,4639,1277,436,6352,63158,0.02585533850322584,-30033,71,3362,416,0.1450179773142129,505,13906,18,3879,804,345,18589,10027,0.046977768882876636,366589,127361,
1060,0.1775012101302369,48,1088,-28,2196,25288,16151,519238,0.02679842012495772,239228,823,0.06976093468445618,46184,4639,1277,436,6352,63158,0.02585533850322584,-30033,71,3362,416,0.1450179773142129,505,13906,18,3879,804,345,18589,10027,0.046977768882876636,366589,127361,
1060,0.1775012101302369,48,1088,-28,2196,25288,16151,519238,0.02679842012495772,239228,823,0.06976093468445618,46184,4639,1277,436,6352,63158,0.02585533850322584,-30033,71,3362,416,0.1450179773142129,505,13906,18,3879,804,345,18589,10027,0.046977768882876636,366589,127361,
1060,0.1775012101302369,48,1088,-28,2196,25288,16151,519238,0.02679842012495772,239228,823,0.06976093468445618,46184,4639,1277,436,6352,63158,0.02585533850322584,-30033,71,3362,416,0.1450179773142129,505,13906,18,3879,804,345,18589,10027,0.046977768882876636,366589,127361,
1060,0.1775012101302369,48,1088,-28,2196,25288,16151,519238,0.02679842012495772,239228,823,0.06976093468445618,46184,4639,1277,436,6352,63158,0.02585533850322584,-30033,71,3362,416,0.1450179773142129,505,13906,18,3879,804,345,18589,10027,0.046977768882876636,366589,127361,
1060,0.1775012101302369,48,1088,-28,2196,25288,16151,519238,0.02679842012495772,239228,823,0.06976093468445618,46184,4639,1277,436,6352,63158,0.02585533850322584,-30033,71,3362,416,0.1450179773142129,505,13906,18,3879,804,345,18589,10027,0.046977768882876636,366589,127361,
1060,0.1775012101302369,48,1088,-28,2196,25288,16151,519238,0.02679842012495772,239228,823,0.06976093468445618,46184,4639,1277,436,6352,63158,0.02585533850322584,-30033,71,3362,416,0.1450179773142129,505,13906,18,3879,804,345,18589,10027,0.046977768882876636,366589,127361,
1060,0.1775012101302369,48,1088,-28,2196,25288,16151,519238,0.02679842012495772,239228,823,0.06976093468445618,46184,4639,1277,436,6352,63158,0.02585533850322584,-30033,71,3362,416,0.1450179773142129,505,13906,18,3879,804,345,18589,10027,0.046977768882876636,366589,127361,
1060,0.04048612700816472,48,1088,-28,2196,25288,16151,519238,0.02679842012495772,239228,823,0.06976093468445618,46184,64,10,0,74,63158,0.02585533850322584,-30033,2,54,39,0.03135394929253142,41,13906,0,3879,804,37,18589,10027,0.046977768882876636,366589,127361,
1060,0.04048612700816472,48,1088,-28,2196,25288,16151,519238,0.02679842012495772,239228,823,0.06976093468445618,46184,64,10,0,74,63158,0.02585533850322584,-30033,2,54,39,0.03135394929253142,41,13906,0,3879,804,37,18589,10027,0.046977768882876636,366589,127361,
1060,0.5148514851485149,48,1088,-28,2196,25288,16151,519238,0.02679842012495772,239228,823,0.06976093468445618,46184,97,4,3,104,63158,0.02585533850322584,-30033,4,93,97,0.5148514851485149,104,13906,3,3879,804,93,18589,10027,0.046977768882876636,366589,127361,
1060,0.18154087227597107,48,1088,-28,2196,25288,16151,519238,0.02679842012495772,239228,823,0.06976093468445618,46184,654,63,80,797,63158,0.02585533850322584,-30033,17,591,64,0.12029306208911544,93,13906,12,3879,804,47,18589,10027,0.046977768882876636,366589,127361,
1060,0.18154087227597107,48,1088,-28,2196,25288,16151,519238,0.02679842012495772,239228,823,0.06976093468445618,46184,654,63,80,797,63158,0.02585533850322584,-30033,17,591,64,0.12029306208911544,93,13906,12,3879,804,47,18589,10027,0.046977768882876636,366589,127361,
1060,0.18154087227597107,48,1088,-28,2196,25288,16151,519238,0.02679842012495772,239228,823,0.06976093468445618,46184,654,63,80,797,63158,0.02585533850322584,-30033,17,591,64,0.12029306208911544,93,13906,12,3879,804,47,18589,10027,0.046977768882876636,366589,127361,
1060,0.18154087227597107,48,1088,-28,2196,25288,16151,519238,0.02679842012495772,239228,823,0.06976093468445618,46184,654,63,80,797,63158,0.02585533850322584,-30033,17,591,64,0.12029306208911544,93,13906,12,3879,804,47,18589,10027,0.046977768882876636,366589,127361,
1060,0.18154087227597107,48,1088,-28,2196,25288,16151,519238,0.02679842012495772,239228,823,0.06976093468445618,46184,654,63,80,797,63158,0.02585533850322584,-30033,17,591,64,0.12029306208911544,93,13906,12,3879,804,47,18589,10027,0.046977768882876636,366589,127361,
1060,0.18154087227597107,48,1088,-28,2196,25288,16151,519238,0.02679842012495772,239228,823,0.06976093468445618,46184,654,63,80,797,63158,0.02585533850322584,-30033,17,591,64,0.12029306208911544,93,13906,12,3879,804,47,18589,10027,0.046977768882876636,366589,127361,
1060,0.18154087227597107,48,1088,-28,2196,25288,16151,519238,0.02679842012495772,239228,823,0.06976093468445618,46184,654,63,80,797,63158,0.02585533850322584,-30033,17,591,64,0.12029306208911544,93,13906,12,3879,804,47,18589,10027,0.046977768882876636,366589,127361,
1060,0.18154087227597107,48,1088,-28,2196,25288,16151,519238,0.02679842012495772,239228,823,0.06976093468445618,46184,654,63,80,797,63158,0.02585533850322584,-30033,17,591,64,0.12029306208911544,93,13906,12,3879,804,47,18589,10027,0.046977768882876636,366589,127361,
1060,0.18154087227597107,48,1088,-28,2196,25288,16151,519238,0.02679842012495772,239228,823,0.06976093468445618,46184,654,63,80,797,63158,0.02585533850322584,-30033,17,591,64,0.12029306208911544,93,13906,12,3879,804,47,18589,10027,0.046977768882876636,366589,127361,
110,0.017699115044247787,10,38,72,158,25288,16151,519238,0.016689729048555365,239228,823,0.06976093468445618,46184,107,18,4,129,63158,0.02585533850322584,-30033,1,89,1,0.031953983185551295,2,3336,0,744,253,0,4333,2592,0.030673515887489955,366589,127361,
1060,0.05186385737439222,48,1088,-28,2196,25288,16151,519238,0.02679842012495772,239228,823,0.06976093468445618,46184,215,37,0,252,63158,0.02585533850322584,-30033,17,178,47,0.012045415496969901,64,13906,0,3879,804,30,18589,10027,0.046977768882876636,366589,127361,
1060,0.05186385737439222,48,1088,-28,2196,25288,16151,519238,0.02679842012495772,239228,823,0.06976093468445618,46184,215,37,0,252,63158,0.02585533850322584,-30033,17,178,47,0.012045415496969901,64,13906,0,3879,804,30,18589,10027,0.046977768882876636,366589,127361,
1060,0.05186385737439222,48,1088,-28,2196,25288,16151,519238,0.02679842012495772,239228,823,0.06976093468445618,46184,215,37,0,252,63158,0.02585533850322584,-30033,17,178,47,0.012045415496969901,64,13906,0,3879,804,30,18589,10027,0.046977768882876636,366589,127361,
1060,0.05186385737439222,48,1088,-28,2196,25288,16151,519238,0.02679842012495772,239228,823,0.06976093468445618,46184,215,37,0,252,63158,0.02585533850322584,-30033,17,178,47,0.012045415496969901,64,13906,0,3879,804,30,18589,10027,0.046977768882876636,366589,127361,
1060,0.0,48,1088,-28,2196,25288,16151,519238,0.02679842012495772,239228,823,0.06976093468445618,46184,76,0,0,76,63158,0.02585533850322584,-30033,0,76,0,0.013532763532763533,0,13906,0,3879,804,0,18589,10027,0.046977768882876636,366589,127361,
1060,0.07791435967081055,48,1088,-28,2196,25288,16151,519238,0.02679842012495772,239228,823,0.06976093468445618,46184,781,791,0,1572,63158,0.02585533850322584,-30033,647,-10,1,0.027391218008851068,648,13906,0,3879,804,-646,18589,10027,0.046977768882876636,366589,127361,
1060,0.07791435967081055,48,1088,-28,2196,25288,16151,519238,0.02679842012495772,239228,823,0.06976093468445618,46184,781,791,0,1572,63158,0.02585533850322584,-30033,647,-10,1,0.027391218008851068,648,13906,0,3879,804,-646,18589,10027,0.046977768882876636,366589,127361,
1060,0.008583690987124463,48,1088,-28,2196,25288,16151,519238,0.02679842012495772,239228,823,0.06976093468445618,46184,35,293,186,514,63158,0.02585533850322584,-30033,1,-258,1,0.06428933012710743,2,13906,0,3879,804,0,18589,10027,0.046977768882876636,366589,127361,
1060,0.008583690987124463,48,1088,-28,2196,25288,16151,519238,0.02679842012495772,239228,823,0.06976093468445618,46184,35,293,186,514,63158,0.02585533850322584,-30033,1,-258,1,0.06428933012710743,2,13906,0,3879,804,0,18589,10027,0.046977768882876636,366589,127361,
1060,0.008583690987124463,48,1088,-28,2196,25288,16151,519238,0.02679842012495772,239228,823,0.06976093468445618,46184,35,293,186,514,63158,0.02585533850322584,-30033,1,-258,1,0.06428933012710743,2,13906,0,3879,804,0,18589,10027,0.046977768882876636,366589,127361,
1060,0.0,48,1088,-28,2196,25288,16151,519238,0.02679842012495772,239228,823,0.06976093468445618,46184,80,0,0,80,63158,0.02585533850322584,-30033,0,80,0,0.02281151981750784,0,13906,0,3879,804,0,18589,10027,0.046977768882876636,366589,127361,
1060,0.0,48,1088,-28,2196,25288,16151,519238,0.02679842012495772,239228,823,0.06976093468445618,46184,80,0,0,80,63158,0.02585533850322584,-30033,0,80,0,0.02281151981750784,0,13906,0,3879,804,0,18589,10027,0.046977768882876636,366589,127361,
1060,0.0,48,1088,-28,2196,25288,16151,519238,0.02679842012495772,239228,823,0.06976093468445618,46184,80,0,0,80,63158,0.02585533850322584,-30033,0,80,0,0.02281151981750784,0,13906,0,3879,804,0,18589,10027,0.046977768882876636,366589,127361,
1060,0.0,48,1088,-28,2196,25288,16151,519238,0.02679842012495772,239228,823,0.06976093468445618,46184,80,0,0,80,63158,0.02585533850322584,-30033,0,80,0,0.02281151981750784,0,13906,0,3879,804,0,18589,10027,0.046977768882876636,366589,127361,
558,0.21897584808259585,22,1115,-557,1695,25288,16151,519238,0.11430771078268123,239228,823,0.06976093468445618,46184,1474,769,100,2343,63158,0.02585533850322584,-30033,8,705,30,0.299504235319234,45,8074,7,5530,323,22,13927,2544,0.1061203948746834,366589,127361,
558,0.21897584808259585,22,1115,-557,1695,25288,16151,519238,0.11430771078268123,239228,823,0.06976093468445618,46184,1474,769,100,2343,63158,0.02585533850322584,-30033,8,705,30,0.299504235319234,45,8074,7,5530,323,22,13927,2544,0.1061203948746834,366589,127361,
558,0.4666666666666667,22,1115,-557,1695,25288,16151,519238,0.11430771078268123,239228,823,0.06976093468445618,46184,21,24,0,45,63158,0.02585533850322584,-30033,19,-3,16,0.1630461922596754,35,8074,0,5530,323,-3,13927,2544,0.1061203948746834,366589,127361,
558,0.4666666666666667,22,1115,-557,1695,25288,16151,519238,0.11430771078268123,239228,823,0.06976093468445618,46184,21,24,0,45,63158,0.02585533850322584,-30033,19,-3,16,0.1630461922596754,35,8074,0,5530,323,-3,13927,2544,0.1061203948746834,366589,127361,
558,0.4666666666666667,22,1115,-557,1695,25288,16151,519238,0.11430771078268123,239228,823,0.06976093468445618,46184,21,24,0,45,63158,0.02585533850322584,-30033,19,-3,16,0.1630461922596754,35,8074,0,5530,323,-3,13927,2544,0.1061203948746834,366589,127361,
558,0.4666666666666667,22,1115,-557,1695,25288,16151,519238,0.11430771078268123,239228,823,0.06976093468445618,46184,21,24,0,45,63158,0.02585533850322584,-30033,19,-3,16,0.1630461922596754,35,8074,0,5530,323,-3,13927,2544,0.1061203948746834,366589,127361,
558,0.7227722772277227,22,1115,-557,1695,25288,16151,519238,0.11430771078268123,239228,823,0.06976093468445618,46184,5,300,0,305,63158,0.02585533850322584,-30033,146,-295,0,0.18136263464706548,146,8074,0,5530,323,-146,13927,2544,0.1061203948746834,366589,127361,
558,0.2546944858420268,22,1115,-557,1695,25288,16151,519238,0.11430771078268123,239228,823,0.06976093468445618,46184,1566,61,40,1667,63158,0.02585533850322584,-30033,12,1505,33,0.3302987159038309,48,8074,3,5530,323,21,13927,2544,0.1061203948746834,366589,127361,
558,0.2546944858420268,22,1115,-557,1695,25288,16151,519238,0.11430771078268123,239228,823,0.06976093468445618,46184,1566,61,40,1667,63158,0.02585533850322584,-30033,12,1505,33,0.3302987159038309,48,8074,3,5530,323,21,13927,2544,0.1061203948746834,366589,127361,
558,0.25799970190825083,22,1115,-557,1695,25288,16151,519238,0.11430771078268123,239228,823,0.06976093468445618,46184,464,515,10,989,63158,0.02585533850322584,-30033,472,-51,211,0.12257401198722931,692,8074,9,5530,323,-261,13927,2544,0.1061203948746834,366589,127361,
558,0.25799970190825083,22,1115,-557,1695,25288,16151,519238,0.11430771078268123,239228,823,0.06976093468445618,46184,464,515,10,989,63158,0.02585533850322584,-30033,472,-51,211,0.12257401198722931,692,8074,9,5530,323,-261,13927,2544,0.1061203948746834,366589,127361,
558,0.25799970190825083,22,1115,-557,1695,25288,16151,519238,0.11430771078268123,239228,823,0.06976093468445618,46184,464,515,10,989,63158,0.02585533850322584,-30033,472,-51,211,0.12257401198722931,692,8074,9,5530,323,-261,13927,2544,0.1061203948746834,366589,127361,
558,0.25799970190825083,22,1115,-557,1695,25288,16151,519238,0.11430771078268123,239228,823,0.06976093468445618,46184,464,515,10,989,63158,0.02585533850322584,-30033,472,-51,211,0.12257401198722931,692,8074,9,5530,323,-261,13927,2544,0.1061203948746834,366589,127361,
558,0.25799970190825083,22,1115,-557,1695,25288,16151,519238,0.11430771078268123,239228,823,0.06976093468445618,46184,464,515,10,989,63158,0.02585533850322584,-30033,472,-51,211,0.12257401198722931,692,8074,9,5530,323,-261,13927,2544,0.1061203948746834,366589,127361,
558,0.25799970190825083,22,1115,-557,1695,25288,16151,519238,0.11430771078268123,239228,823,0.06976093468445618,46184,464,515,10,989,63158,0.02585533850322584,-30033,472,-51,211,0.12257401198722931,692,8074,9,5530,323,-261,13927,2544,0.1061203948746834,366589,127361,
558,0.25799970190825083,22,1115,-557,1695,25288,16151,519238,0.11430771078268123,239228,823,0.06976093468445618,46184,464,515,10,989,63158,0.02585533850322584,-30033,472,-51,211,0.12257401198722931,692,8074,9,5530,323,-261,13927,2544,0.1061203948746834,366589,127361,
558,0.08403361344537816,22,1115,-557,1695,25288,16151,519238,0.11430771078268123,239228,823,0.06976093468445618,46184,2351,2076,109,4536,63158,0.02585533850322584,-30033,5,275,2,0.2156091462435345,10,8074,3,5530,323,-3,13927,2544,0.1061203948746834,366589,127361,
558,0.08403361344537816,22,1115,-557,1695,25288,16151,519238,0.11430771078268123,239228,823,0.06976093468445618,46184,2351,2076,109,4536,63158,0.02585533850322584,-30033,5,275,2,0.2156091462435345,10,8074,3,5530,323,-3,13927,2544,0.1061203948746834,366589,127361,
558,0.10970744680851063,22,1115,-557,1695,25288,16151,519238,0.11430771078268123,239228,823,0.06976093468445618,46184,809,507,14,1330,63158,0.02585533850322584,-30033,4,302,5,0.08722067167703934,9,8074,0,5530,323,1,13927,2544,0.1061203948746834,366589,127361,
558,0.10970744680851063,22,1115,-557,1695,25288,16151,519238,0.11430771078268123,239228,823,0.06976093468445618,46184,809,507,14,1330,63158,0.02585533850322584,-30033,4,302,5,0.08722067167703934,9,8074,0,5530,323,1,13927,2544,0.1061203948746834,366589,127361,
558,0.10970744680851063,22,1115,-557,1695,25288,16151,519238,0.11430771078268123,239228,823,0.06976093468445618,46184,809,507,14,1330,63158,0.02585533850322584,-30033,4,302,5,0.08722067167703934,9,8074,0,5530,323,1,13927,2544,0.1061203948746834,366589,127361,
558,0.0,22,1115,-557,1695,25288,16151,519238,0.11430771078268123,239228,823,0.06976093468445618,46184,20,4,13,37,63158,0.02585533850322584,-30033,0,16,0,0.041229690422727595,0,8074,0,5530,323,0,13927,2544,0.1061203948746834,366589,127361,
558,0.3202614379084967,22,1115,-557,1695,25288,16151,519238,0.11430771078268123,239228,823,0.06976093468445618,46184,44,1066,12,1122,63158,0.02585533850322584,-30033,441,-1022,0,0.072231832647295,441,8074,0,5530,323,-441,13927,2544,0.1061203948746834,366589,127361,
558,0.3202614379084967,22,1115,-557,1695,25288,16151,519238,0.11430771078268123,239228,823,0.06976093468445618,46184,44,1066,12,1122,63158,0.02585533850322584,-30033,441,-1022,0,0.072231832647295,441,8074,0,5530,323,-441,13927,2544,0.1061203948746834,366589,127361,
558,0.3202614379084967,22,1115,-557,1695,25288,16151,519238,0.11430771078268123,239228,823,0.06976093468445618,46184,44,1066,12,1122,63158,0.02585533850322584,-30033,441,-1022,0,0.072231832647295,441,8074,0,5530,323,-441,13927,2544,0.1061203948746834,366589,127361,
558,0.0,22,1115,-557,1695,25288,16151,519238,0.11430771078268123,239228,823,0.06976093468445618,46184,285,108,18,411,63158,0.02585533850322584,-30033,0,177,0,0.13934748427672955,0,8074,0,5530,323,0,13927,2544,0.1061203948746834,366589,127361,
558,0.0,22,1115,-557,1695,25288,16151,519238,0.11430771078268123,239228,823,0.06976093468445618,46184,204,2,1,207,63158,0.02585533850322584,-30033,0,202,0,0.10408722112890596,0,8074,0,5530,323,0,13927,2544,0.1061203948746834,366589,127361,
558,0.13333333333333333,22,1115,-557,1695,25288,16151,519238,0.11430771078268123,239228,823,0.06976093468445618,46184,62,6,0,68,63158,0.02585533850322584,-30033,1,56,1,0.04513026781817239,2,8074,0,5530,323,0,13927,2544,0.1061203948746834,366589,127361,
0,0.0,0,0,0,0,25288,16151,519238,0.0,239228,823,0.06976093468445618,46184,5,5,0,10,63158,0.02585533850322584,-30033,0,0,0,0.08064516129032258,0,73,0,10,0,0,83,63,0.057572210881721965,366589,127361,
0,0.0,0,0,0,0,25288,16151,519238,0.0,239228,823,0.06976093468445618,46184,5,5,0,10,63158,0.02585533850322584,-30033,0,0,0,0.08064516129032258,0,73,0,10,0,0,83,63,0.057572210881721965,366589,127361,
0,0.0,0,0,0,0,25288,16151,519238,0.0,239228,823,0.06976093468445618,46184,5,5,0,10,63158,0.02585533850322584,-30033,0,0,0,0.08064516129032258,0,73,0,10,0,0,83,63,0.057572210881721965,366589,127361,
0,0.0,0,0,0,0,25288,16151,519238,0.0,239228,823,0.06976093468445618,46184,5,5,0,10,63158,0.02585533850322584,-30033,0,0,0,0.08064516129032258,0,73,0,10,0,0,83,63,0.057572210881721965,366589,127361,
4,0.0,0,4,0,8,25288,16151,519238,0.06458333333333333,239228,823,0.06976093468445618,46184,59,9,0,68,63158,0.02585533850322584,-30033,0,50,0,0.17226913150240497,0,418,0,31,0,0,449,387,0.11843144249293004,366589,127361,
1365,0.08389225119793263,20,242,1123,1627,25288,16151,519238,0.13982371733004023,239228,823,0.06976093468445618,46184,367,17,0,384,63158,0.02585533850322584,-30033,17,350,367,0.08389225119793263,384,3134,0,456,78,350,3668,2678,0.12086483264586088,366589,127361,
1365,0.29405216724204064,20,242,1123,1627,25288,16151,519238,0.13982371733004023,239228,823,0.06976093468445618,46184,342,0,0,342,63158,0.02585533850322584,-30033,0,342,342,0.29405216724204064,342,3134,0,456,78,342,3668,2678,0.12086483264586088,366589,127361,
1365,0.29405216724204064,20,242,1123,1627,25288,16151,519238,0.13982371733004023,239228,823,0.06976093468445618,46184,342,0,0,342,63158,0.02585533850322584,-30033,0,342,342,0.29405216724204064,342,3134,0,456,78,342,3668,2678,0.12086483264586088,366589,127361,
1365,0.29405216724204064,20,242,1123,1627,25288,16151,519238,0.13982371733004023,239228,823,0.06976093468445618,46184,342,0,0,342,63158,0.02585533850322584,-30033,0,342,342,0.29405216724204064,342,3134,0,456,78,342,3668,2678,0.12086483264586088,366589,127361,
1365,0.29405216724204064,20,242,1123,1627,25288,16151,519238,0.13982371733004023,239228,823,0.06976093468445618,46184,342,0,0,342,63158,0.02585533850322584,-30033,0,342,342,0.29405216724204064,342,3134,0,456,78,342,3668,2678,0.12086483264586088,366589,127361,
1365,0.29405216724204064,20,242,1123,1627,25288,16151,519238,0.13982371733004023,239228,823,0.06976093468445618,46184,342,0,0,342,63158,0.02585533850322584,-30033,0,342,342,0.29405216724204064,342,3134,0,456,78,342,3668,2678,0.12086483264586088,366589,127361,
1365,0.2641921896673976,20,242,1123,1627,25288,16151,519238,0.13982371733004023,239228,823,0.06976093468445618,46184,1274,205,58,1537,63158,0.02585533850322584,-30033,107,1069,78,0.21278445701375862,196,3134,11,456,78,-29,3668,2678,0.12086483264586088,366589,127361,
1365,0.03211528899684553,20,242,1123,1627,25288,16151,519238,0.13982371733004023,239228,823,0.06976093468445618,46184,167,30,0,197,63158,0.02585533850322584,-30033,2,137,14,0.03057567147196804,16,3134,0,456,78,12,3668,2678,0.12086483264586088,366589,127361,
1365,0.18343803528909977,20,242,1123,1627,25288,16151,519238,0.13982371733004023,239228,823,0.06976093468445618,46184,424,122,12,558,63158,0.02585533850322584,-30033,38,302,88,0.12581195434559403,127,3134,1,456,78,50,3668,2678,0.12086483264586088,366589,127361,
2,0.0,0,2,0,4,25288,16151,519238,0.00202020202020202,239228,823,0.06976093468445618,46184,16,10,0,26,63158,0.02585533850322584,-30033,0,6,0,0.030256717756717757,0,2320,0,171,16,0,2507,2149,0.046208165273217805,366589,127361,
2,0.0,0,2,0,4,25288,16151,519238,0.00202020202020202,239228,823,0.06976093468445618,46184,16,10,0,26,63158,0.02585533850322584,-30033,0,6,0,0.030256717756717757,0,2320,0,171,16,0,2507,2149,0.046208165273217805,366589,127361,
2,0.0,0,2,0,4,25288,16151,519238,0.00202020202020202,239228,823,0.06976093468445618,46184,16,10,0,26,63158,0.02585533850322584,-30033,0,6,0,0.030256717756717757,0,2320,0,171,16,0,2507,2149,0.046208165273217805,366589,127361,
2,0.0,0,2,0,4,25288,16151,519238,0.00202020202020202,239228,823,0.06976093468445618,46184,16,10,0,26,63158,0.02585533850322584,-30033,0,6,0,0.030256717756717757,0,2320,0,171,16,0,2507,2149,0.046208165273217805,366589,127361,
2,0.0,0,2,0,4,25288,16151,519238,0.00202020202020202,239228,823,0.06976093468445618,46184,16,10,0,26,63158,0.02585533850322584,-30033,0,6,0,0.030256717756717757,0,2320,0,171,16,0,2507,2149,0.046208165273217805,366589,127361,
2,0.0,0,2,0,4,25288,16151,519238,0.00202020202020202,239228,823,0.06976093468445618,46184,757,17,0,774,63158,0.02585533850322584,-30033,0,740,0,0.059193874891648596,0,2320,0,171,16,0,2507,2149,0.046208165273217805,366589,127361,
2,0.0,0,2,0,4,25288,16151,519238,0.00202020202020202,239228,823,0.06976093468445618,46184,353,37,1,391,63158,0.02585533850322584,-30033,0,316,0,0.067990602832729,0,2320,0,171,16,0,2507,2149,0.046208165273217805,366589,127361,
2,0.0,0,2,0,4,25288,16151,519238,0.00202020202020202,239228,823,0.06976093468445618,46184,97,6,1,104,63158,0.02585533850322584,-30033,0,91,0,0.054940148183857354,0,2320,0,171,16,0,2507,2149,0.046208165273217805,366589,127361,
2,0.0,0,2,0,4,25288,16151,519238,0.00202020202020202,239228,823,0.06976093468445618,46184,97,6,1,104,63158,0.02585533850322584,-30033,0,91,0,0.054940148183857354,0,2320,0,171,16,0,2507,2149,0.046208165273217805,366589,127361,
2,0.0,0,2,0,4,25288,16151,519238,0.00202020202020202,239228,823,0.06976093468445618,46184,126,13,5,144,63158,0.02585533850322584,-30033,0,113,0,0.08396752526057183,0,2320,0,171,16,0,2507,2149,0.046208165273217805,366589,127361,
2,0.0,0,2,0,4,25288,16151,519238,0.00202020202020202,239228,823,0.06976093468445618,46184,126,13,5,144,63158,0.02585533850322584,-30033,0,113,0,0.08396752526057183,0,2320,0,171,16,0,2507,2149,0.046208165273217805,366589,127361,
110,0.0,10,38,72,158,25288,16151,519238,0.016689729048555365,239228,823,0.06976093468445618,46184,249,1,0,250,63158,0.02585533850322584,-30033,0,248,0,0.049659998028974084,0,3336,0,744,253,0,4333,2592,0.030673515887489955,366589,127361,
110,0.0,10,38,72,158,25288,16151,519238,0.016689729048555365,239228,823,0.06976093468445618,46184,249,1,0,250,63158,0.02585533850322584,-30033,0,248,0,0.049659998028974084,0,3336,0,744,253,0,4333,2592,0.030673515887489955,366589,127361,
110,0.0,10,38,72,158,25288,16151,519238,0.016689729048555365,239228,823,0.06976093468445618,46184,249,1,0,250,63158,0.02585533850322584,-30033,0,248,0,0.049659998028974084,0,3336,0,744,253,0,4333,2592,0.030673515887489955,366589,127361,
110,0.0,10,38,72,158,25288,16151,519238,0.016689729048555365,239228,823,0.06976093468445618,46184,249,1,0,250,63158,0.02585533850322584,-30033,0,248,0,0.049659998028974084,0,3336,0,744,253,0,4333,2592,0.030673515887489955,366589,127361,
110,0.05471755946025995,10,38,72,158,25288,16151,519238,0.016689729048555365,239228,823,0.06976093468445618,46184,25,15,7,47,63158,0.02585533850322584,-30033,10,10,20,0.08698342347855714,37,3336,7,744,253,10,4333,2592,0.030673515887489955,366589,127361,
110,0.05471755946025995,10,38,72,158,25288,16151,519238,0.016689729048555365,239228,823,0.06976093468445618,46184,25,15,7,47,63158,0.02585533850322584,-30033,10,10,20,0.08698342347855714,37,3336,7,744,253,10,4333,2592,0.030673515887489955,366589,127361,
110,0.05471755946025995,10,38,72,158,25288,16151,519238,0.016689729048555365,239228,823,0.06976093468445618,46184,25,15,7,47,63158,0.02585533850322584,-30033,10,10,20,0.08698342347855714,37,3336,7,744,253,10,4333,2592,0.030673515887489955,366589,127361,
110,0.056179775280898875,10,38,72,158,25288,16151,519238,0.016689729048555365,239228,823,0.06976093468445618,46184,2788,684,235,3707,63158,0.02585533850322584,-30033,7,2104,5,0.07698081486800208,15,3336,3,744,253,-2,4333,2592,0.030673515887489955,366589,127361,
110,0.035856573705179286,10,38,72,158,25288,16151,519238,0.016689729048555365,239228,823,0.06976093468445618,46184,0,18,0,18,63158,0.02585533850322584,-30033,18,-18,0,0.035856573705179286,18,3336,0,744,253,-18,4333,2592,0.030673515887489955,366589,127361,
110,0.032498447992545025,0,12,98,122,25288,16151,519238,0.006385207310310034,239228,823,0.06976093468445618,46184,19,16,0,35,63158,0.02585533850322584,-30033,5,3,10,0.033401179377770394,15,687,0,105,54,5,846,582,0.018906010689270492,366589,127361,
110,0.032498447992545025,0,12,98,122,25288,16151,519238,0.006385207310310034,239228,823,0.06976093468445618,46184,19,16,0,35,63158,0.02585533850322584,-30033,5,3,10,0.033401179377770394,15,687,0,105,54,5,846,582,0.018906010689270492,366589,127361,
10,0.010008340283569641,0,2,8,12,25288,16151,519238,0.003336113427856547,239228,823,0.06976093468445618,46184,14,11,0,25,63158,0.02585533850322584,-30033,2,3,10,0.043823472184733626,12,51,0,13,0,8,64,38,0.017085104434525746,366589,127361,
8,0.0,0,7,1,15,25288,16151,519238,1.1003298760735831E-4,239228,823,0.06976093468445618,46184,72,0,0,72,63158,0.02585533850322584,-30033,0,72,0,0.0023424171567834,0,1282,0,303,1,0,1586,979,0.00904318321538116,366589,127361,
8,0.0,0,7,1,15,25288,16151,519238,1.1003298760735831E-4,239228,823,0.06976093468445618,46184,72,0,0,72,63158,0.02585533850322584,-30033,0,72,0,0.0023424171567834,0,1282,0,303,1,0,1586,979,0.00904318321538116,366589,127361,
8,0.0,0,7,1,15,25288,16151,519238,1.1003298760735831E-4,239228,823,0.06976093468445618,46184,120,0,0,120,63158,0.02585533850322584,-30033,0,120,0,0.02302112643157717,0,1282,0,303,1,0,1586,979,0.00904318321538116,366589,127361,
8,0.0,0,7,1,15,25288,16151,519238,1.1003298760735831E-4,239228,823,0.06976093468445618,46184,61,0,0,61,63158,0.02585533850322584,-30033,0,61,0,0.013141401476224356,0,1282,0,303,1,0,1586,979,0.00904318321538116,366589,127361,
8,0.0,0,7,1,15,25288,16151,519238,1.1003298760735831E-4,239228,823,0.06976093468445618,46184,79,0,0,79,63158,0.02585533850322584,-30033,0,79,0,0.0046791360308464465,0,1282,0,303,1,0,1586,979,0.00904318321538116,366589,127361,
377,0.023332702680454422,1,262,115,640,25288,16151,519238,0.015932086799547326,239228,823,0.06976093468445618,46184,1849,765,125,2739,63158,0.02585533850322584,-30033,13,1084,44,0.06487502717973057,57,4410,0,1577,513,31,6500,2833,0.032847227297759386,366589,127361,
377,0.023332702680454422,1,262,115,640,25288,16151,519238,0.015932086799547326,239228,823,0.06976093468445618,46184,1849,765,125,2739,63158,0.02585533850322584,-30033,13,1084,44,0.06487502717973057,57,4410,0,1577,513,31,6500,2833,0.032847227297759386,366589,127361,
377,0.023332702680454422,1,262,115,640,25288,16151,519238,0.015932086799547326,239228,823,0.06976093468445618,46184,1849,765,125,2739,63158,0.02585533850322584,-30033,13,1084,44,0.06487502717973057,57,4410,0,1577,513,31,6500,2833,0.032847227297759386,366589,127361,
377,0.023332702680454422,1,262,115,640,25288,16151,519238,0.015932086799547326,239228,823,0.06976093468445618,46184,1849,765,125,2739,63158,0.02585533850322584,-30033,13,1084,44,0.06487502717973057,57,4410,0,1577,513,31,6500,2833,0.032847227297759386,366589,127361,
377,0.023332702680454422,1,262,115,640,25288,16151,519238,0.015932086799547326,239228,823,0.06976093468445618,46184,1849,765,125,2739,63158,0.02585533850322584,-30033,13,1084,44,0.06487502717973057,57,4410,0,1577,513,31,6500,2833,0.032847227297759386,366589,127361,
377,0.023332702680454422,1,262,115,640,25288,16151,519238,0.015932086799547326,239228,823,0.06976093468445618,46184,1849,765,125,2739,63158,0.02585533850322584,-30033,13,1084,44,0.06487502717973057,57,4410,0,1577,513,31,6500,2833,0.032847227297759386,366589,127361,
377,7.352941176470588E-4,1,262,115,640,25288,16151,519238,0.015932086799547326,239228,823,0.06976093468445618,46184,1,0,0,1,63158,0.02585533850322584,-30033,0,1,1,7.352941176470588E-4,1,4410,0,1577,513,1,6500,2833,0.032847227297759386,366589,127361,
377,7.352941176470588E-4,1,262,115,640,25288,16151,519238,0.015932086799547326,239228,823,0.06976093468445618,46184,1,0,0,1,63158,0.02585533850322584,-30033,0,1,1,7.352941176470588E-4,1,4410,0,1577,513,1,6500,2833,0.032847227297759386,366589,127361,
187,0.050416075560150514,11,58,129,256,25288,16151,519238,0.015951537736873283,239228,823,0.06976093468445618,46184,92,239,19,350,63158,0.02585533850322584,-30033,26,-147,36,0.11328169184868246,73,796,11,389,47,10,1232,407,0.03078522228717281,366589,127361,
187,0.04665148755959807,11,58,129,256,25288,16151,519238,0.015951537736873283,239228,823,0.06976093468445618,46184,391,79,17,487,63158,0.02585533850322584,-30033,15,312,139,0.048506571307640405,154,796,0,389,47,124,1232,407,0.03078522228717281,366589,127361,
844,0.21264367816091956,25,174,670,1043,25288,16151,519238,0.07454349238635037,239228,823,0.06976093468445618,46184,56,42,18,116,63158,0.02585533850322584,-30033,24,14,30,0.14131622518849554,54,1482,0,308,56,6,1846,1174,0.07545838289268485,366589,127361,
844,0.2013073342175766,25,174,670,1043,25288,16151,519238,0.07454349238635037,239228,823,0.06976093468445618,46184,840,168,27,1035,63158,0.02585533850322584,-30033,85,672,325,0.1760715098360877,424,1482,14,308,56,240,1846,1174,0.07545838289268485,366589,127361,
844,0.2013073342175766,25,174,670,1043,25288,16151,519238,0.07454349238635037,239228,823,0.06976093468445618,46184,840,168,27,1035,63158,0.02585533850322584,-30033,85,672,325,0.1760715098360877,424,1482,14,308,56,240,1846,1174,0.07545838289268485,366589,127361,
844,0.2013073342175766,25,174,670,1043,25288,16151,519238,0.07454349238635037,239228,823,0.06976093468445618,46184,840,168,27,1035,63158,0.02585533850322584,-30033,85,672,325,0.1760715098360877,424,1482,14,308,56,240,1846,1174,0.07545838289268485,366589,127361,
844,0.2013073342175766,25,174,670,1043,25288,16151,519238,0.07454349238635037,239228,823,0.06976093468445618,46184,840,168,27,1035,63158,0.02585533850322584,-30033,85,672,325,0.1760715098360877,424,1482,14,308,56,240,1846,1174,0.07545838289268485,366589,127361,
844,0.2013073342175766,25,174,670,1043,25288,16151,519238,0.07454349238635037,239228,823,0.06976093468445618,46184,840,168,27,1035,63158,0.02585533850322584,-30033,85,672,325,0.1760715098360877,424,1482,14,308,56,240,1846,1174,0.07545838289268485,366589,127361,
844,0.2013073342175766,25,174,670,1043,25288,16151,519238,0.07454349238635037,239228,823,0.06976093468445618,46184,840,168,27,1035,63158,0.02585533850322584,-30033,85,672,325,0.1760715098360877,424,1482,14,308,56,240,1846,1174,0.07545838289268485,366589,127361,
844,0.2013073342175766,25,174,670,1043,25288,16151,519238,0.07454349238635037,239228,823,0.06976093468445618,46184,840,168,27,1035,63158,0.02585533850322584,-30033,85,672,325,0.1760715098360877,424,1482,14,308,56,240,1846,1174,0.07545838289268485,366589,127361,
844,0.207543246942028,25,174,670,1043,25288,16151,519238,0.07454349238635037,239228,823,0.06976093468445618,46184,381,48,2,431,63158,0.02585533850322584,-30033,48,333,381,0.207543246942028,431,1482,2,308,56,333,1846,1174,0.07545838289268485,366589,127361,
844,0.207543246942028,25,174,670,1043,25288,16151,519238,0.07454349238635037,239228,823,0.06976093468445618,46184,381,48,2,431,63158,0.02585533850322584,-30033,48,333,381,0.207543246942028,431,1482,2,308,56,333,1846,1174,0.07545838289268485,366589,127361,
844,0.029677897121955905,25,174,670,1043,25288,16151,519238,0.07454349238635037,239228,823,0.06976093468445618,46184,53,9,9,71,63158,0.02585533850322584,-30033,9,44,53,0.029677897121955905,71,1482,9,308,56,44,1846,1174,0.07545838289268485,366589,127361,
844,0.029677897121955905,25,174,670,1043,25288,16151,519238,0.07454349238635037,239228,823,0.06976093468445618,46184,53,9,9,71,63158,0.02585533850322584,-30033,9,44,53,0.029677897121955905,71,1482,9,308,56,44,1846,1174,0.07545838289268485,366589,127361,
844,0.029677897121955905,25,174,670,1043,25288,16151,519238,0.07454349238635037,239228,823,0.06976093468445618,46184,53,9,9,71,63158,0.02585533850322584,-30033,9,44,53,0.029677897121955905,71,1482,9,308,56,44,1846,1174,0.07545838289268485,366589,127361,
0,0.0,0,0,0,0,25288,16151,519238,0.0,239228,823,0.06976093468445618,46184,74,24,0,98,63158,0.02585533850322584,-30033,0,50,0,0.043280506863445894,0,457,0,210,35,0,702,247,0.2984555166188062,366589,127361,
169,0.06738437001594896,0,0,169,169,25288,16151,519238,0.06738437001594896,239228,823,0.06976093468445618,46184,169,0,0,169,63158,0.02585533850322584,-30033,0,169,169,0.06738437001594896,169,169,0,0,0,169,169,169,0.06738437001594896,366589,127361,
0,0.005626344530862155,0,166,-166,166,25288,16151,519238,0.006734186903688112,239228,823,0.06976093468445618,46184,34,34,0,68,63158,0.02585533850322584,-30033,34,0,0,0.008974825038174825,34,175,0,327,0,-34,502,-152,0.0572753900902838,366589,127361,
0,0.007678483907858193,0,166,-166,166,25288,16151,519238,0.006734186903688112,239228,823,0.06976093468445618,46184,47,94,0,141,63158,0.02585533850322584,-30033,47,-47,0,0.07620610285635793,47,175,0,327,0,-47,502,-152,0.0572753900902838,366589,127361,
0,0.007678483907858193,0,166,-166,166,25288,16151,519238,0.006734186903688112,239228,823,0.06976093468445618,46184,47,94,0,141,63158,0.02585533850322584,-30033,47,-47,0,0.07620610285635793,47,175,0,327,0,-47,502,-152,0.0572753900902838,366589,127361,
0,0.011966049812160847,0,718,-718,718,25288,16151,519238,0.01739016918707446,239228,823,0.06976093468445618,46184,86,172,0,258,63158,0.02585533850322584,-30033,86,-86,0,0.027162677429989898,86,427,0,1445,0,-86,1872,-1018,0.06575530531062261,366589,127361,
0,0.008105492378417614,0,67,-67,67,25288,16151,519238,0.008105492378417614,239228,823,0.06976093468445618,46184,16,148,0,164,63158,0.02585533850322584,-30033,67,-132,0,0.008862373750531432,67,16,0,148,0,-67,164,-132,0.008862373750531432,366589,127361,
52,0.008688267572511106,0,2258,-2206,2310,25288,16151,519238,0.023131550473808295,239228,823,0.06976093468445618,46184,6,798,0,804,63158,0.02585533850322584,-30033,266,-792,0,0.017676307999797924,266,1803,0,6061,5,-266,7869,-4258,0.034469349198520766,366589,127361,
52,0.008688267572511106,0,2258,-2206,2310,25288,16151,519238,0.023131550473808295,239228,823,0.06976093468445618,46184,6,798,0,804,63158,0.02585533850322584,-30033,266,-792,0,0.017676307999797924,266,1803,0,6061,5,-266,7869,-4258,0.034469349198520766,366589,127361,
52,0.031011615777613608,0,2258,-2206,2310,25288,16151,519238,0.023131550473808295,239228,823,0.06976093468445618,46184,622,1600,5,2227,63158,0.02585533850322584,-30033,646,-978,44,0.11176716943689564,690,1803,0,6061,5,-602,7869,-4258,0.034469349198520766,366589,127361,
52,0.031011615777613608,0,2258,-2206,2310,25288,16151,519238,0.023131550473808295,239228,823,0.06976093468445618,46184,622,1600,5,2227,63158,0.02585533850322584,-30033,646,-978,44,0.11176716943689564,690,1803,0,6061,5,-602,7869,-4258,0.034469349198520766,366589,127361,
52,0.031011615777613608,0,2258,-2206,2310,25288,16151,519238,0.023131550473808295,239228,823,0.06976093468445618,46184,622,1600,5,2227,63158,0.02585533850322584,-30033,646,-978,44,0.11176716943689564,690,1803,0,6061,5,-602,7869,-4258,0.034469349198520766,366589,127361,
52,0.031011615777613608,0,2258,-2206,2310,25288,16151,519238,0.023131550473808295,239228,823,0.06976093468445618,46184,622,1600,5,2227,63158,0.02585533850322584,-30033,646,-978,44,0.11176716943689564,690,1803,0,6061,5,-602,7869,-4258,0.034469349198520766,366589,127361,
52,0.031011615777613608,0,2258,-2206,2310,25288,16151,519238,0.023131550473808295,239228,823,0.06976093468445618,46184,622,1600,5,2227,63158,0.02585533850322584,-30033,646,-978,44,0.11176716943689564,690,1803,0,6061,5,-602,7869,-4258,0.034469349198520766,366589,127361,
52,0.031011615777613608,0,2258,-2206,2310,25288,16151,519238,0.023131550473808295,239228,823,0.06976093468445618,46184,622,1600,5,2227,63158,0.02585533850322584,-30033,646,-978,44,0.11176716943689564,690,1803,0,6061,5,-602,7869,-4258,0.034469349198520766,366589,127361,
52,0.031011615777613608,0,2258,-2206,2310,25288,16151,519238,0.023131550473808295,239228,823,0.06976093468445618,46184,622,1600,5,2227,63158,0.02585533850322584,-30033,646,-978,44,0.11176716943689564,690,1803,0,6061,5,-602,7869,-4258,0.034469349198520766,366589,127361,
52,0.006129788897576232,0,2258,-2206,2310,25288,16151,519238,0.023131550473808295,239228,823,0.06976093468445618,46184,194,580,0,774,63158,0.02585533850322584,-30033,196,-386,0,0.010158137196307837,196,1803,0,6061,5,-196,7869,-4258,0.034469349198520766,366589,127361,
52,0.006129788897576232,0,2258,-2206,2310,25288,16151,519238,0.023131550473808295,239228,823,0.06976093468445618,46184,194,580,0,774,63158,0.02585533850322584,-30033,196,-386,0,0.010158137196307837,196,1803,0,6061,5,-196,7869,-4258,0.034469349198520766,366589,127361,
52,0.006129788897576232,0,2258,-2206,2310,25288,16151,519238,0.023131550473808295,239228,823,0.06976093468445618,46184,194,580,0,774,63158,0.02585533850322584,-30033,196,-386,0,0.010158137196307837,196,1803,0,6061,5,-196,7869,-4258,0.034469349198520766,366589,127361,
52,0.006129788897576232,0,2258,-2206,2310,25288,16151,519238,0.023131550473808295,239228,823,0.06976093468445618,46184,194,580,0,774,63158,0.02585533850322584,-30033,196,-386,0,0.010158137196307837,196,1803,0,6061,5,-196,7869,-4258,0.034469349198520766,366589,127361,
259,0.006746719485021045,10,4591,-4332,4860,25288,16151,519238,0.0196819339623457,239228,823,0.06976093468445618,46184,11,229,0,240,63158,0.02585533850322584,-30033,218,-218,0,0.02623705598473191,218,3351,0,5418,46,-218,8815,-2067,0.031084241059056363,366589,127361,
259,0.0026640191941755603,10,4591,-4332,4860,25288,16151,519238,0.0196819339623457,239228,823,0.06976093468445618,46184,285,58,1,344,63158,0.02585533850322584,-30033,1,227,1,0.008005287225249132,2,3351,0,5418,46,0,8815,-2067,0.031084241059056363,366589,127361,
259,0.0050733962081696195,10,4591,-4332,4860,25288,16151,519238,0.0196819339623457,239228,823,0.06976093468445618,46184,110,375,0,485,63158,0.02585533850322584,-30033,260,-265,1,0.02940432399368318,261,3351,0,5418,46,-259,8815,-2067,0.031084241059056363,366589,127361,
259,0.0050733962081696195,10,4591,-4332,4860,25288,16151,519238,0.0196819339623457,239228,823,0.06976093468445618,46184,110,375,0,485,63158,0.02585533850322584,-30033,260,-265,1,0.02940432399368318,261,3351,0,5418,46,-259,8815,-2067,0.031084241059056363,366589,127361,
259,0.0050733962081696195,10,4591,-4332,4860,25288,16151,519238,0.0196819339623457,239228,823,0.06976093468445618,46184,110,375,0,485,63158,0.02585533850322584,-30033,260,-265,1,0.02940432399368318,261,3351,0,5418,46,-259,8815,-2067,0.031084241059056363,366589,127361,
259,0.002674446875759786,10,4591,-4332,4860,25288,16151,519238,0.0196819339623457,239228,823,0.06976093468445618,46184,97,98,0,195,63158,0.02585533850322584,-30033,88,-1,0,0.003975698033211582,88,3351,0,5418,46,-88,8815,-2067,0.031084241059056363,366589,127361,
259,0.11961722488038277,10,4591,-4332,4860,25288,16151,519238,0.0196819339623457,239228,823,0.06976093468445618,46184,100,0,0,100,63158,0.02585533850322584,-30033,0,100,100,0.11961722488038277,100,3351,0,5418,46,100,8815,-2067,0.031084241059056363,366589,127361,
259,0.005722214723000818,10,4591,-4332,4860,25288,16151,519238,0.0196819339623457,239228,823,0.06976093468445618,46184,301,325,0,626,63158,0.02585533850322584,-30033,290,-24,2,0.015649096519225674,292,3351,0,5418,46,-288,8815,-2067,0.031084241059056363,366589,127361,
259,0.005722214723000818,10,4591,-4332,4860,25288,16151,519238,0.0196819339623457,239228,823,0.06976093468445618,46184,301,325,0,626,63158,0.02585533850322584,-30033,290,-24,2,0.015649096519225674,292,3351,0,5418,46,-288,8815,-2067,0.031084241059056363,366589,127361,
259,0.005722214723000818,10,4591,-4332,4860,25288,16151,519238,0.0196819339623457,239228,823,0.06976093468445618,46184,301,325,0,626,63158,0.02585533850322584,-30033,290,-24,2,0.015649096519225674,292,3351,0,5418,46,-288,8815,-2067,0.031084241059056363,366589,127361,
259,0.005722214723000818,10,4591,-4332,4860,25288,16151,519238,0.0196819339623457,239228,823,0.06976093468445618,46184,301,325,0,626,63158,0.02585533850322584,-30033,290,-24,2,0.015649096519225674,292,3351,0,5418,46,-288,8815,-2067,0.031084241059056363,366589,127361,
259,0.005722214723000818,10,4591,-4332,4860,25288,16151,519238,0.0196819339623457,239228,823,0.06976093468445618,46184,301,325,0,626,63158,0.02585533850322584,-30033,290,-24,2,0.015649096519225674,292,3351,0,5418,46,-288,8815,-2067,0.031084241059056363,366589,127361,
259,0.005722214723000818,10,4591,-4332,4860,25288,16151,519238,0.0196819339623457,239228,823,0.06976093468445618,46184,301,325,0,626,63158,0.02585533850322584,-30033,290,-24,2,0.015649096519225674,292,3351,0,5418,46,-288,8815,-2067,0.031084241059056363,366589,127361,
259,0.005722214723000818,10,4591,-4332,4860,25288,16151,519238,0.0196819339623457,239228,823,0.06976093468445618,46184,301,325,0,626,63158,0.02585533850322584,-30033,290,-24,2,0.015649096519225674,292,3351,0,5418,46,-288,8815,-2067,0.031084241059056363,366589,127361,
259,0.005722214723000818,10,4591,-4332,4860,25288,16151,519238,0.0196819339623457,239228,823,0.06976093468445618,46184,301,325,0,626,63158,0.02585533850322584,-30033,290,-24,2,0.015649096519225674,292,3351,0,5418,46,-288,8815,-2067,0.031084241059056363,366589,127361,
259,0.005722214723000818,10,4591,-4332,4860,25288,16151,519238,0.0196819339623457,239228,823,0.06976093468445618,46184,301,325,0,626,63158,0.02585533850322584,-30033,290,-24,2,0.015649096519225674,292,3351,0,5418,46,-288,8815,-2067,0.031084241059056363,366589,127361,
259,0.0022053276072195463,10,4591,-4332,4860,25288,16151,519238,0.0196819339623457,239228,823,0.06976093468445618,46184,6,83,0,89,63158,0.02585533850322584,-30033,76,-77,0,0.004410326445182844,76,3351,0,5418,46,-76,8815,-2067,0.031084241059056363,366589,127361,
259,0.0022053276072195463,10,4591,-4332,4860,25288,16151,519238,0.0196819339623457,239228,823,0.06976093468445618,46184,6,83,0,89,63158,0.02585533850322584,-30033,76,-77,0,0.004410326445182844,76,3351,0,5418,46,-76,8815,-2067,0.031084241059056363,366589,127361,
259,0.0022053276072195463,10,4591,-4332,4860,25288,16151,519238,0.0196819339623457,239228,823,0.06976093468445618,46184,6,83,0,89,63158,0.02585533850322584,-30033,76,-77,0,0.004410326445182844,76,3351,0,5418,46,-76,8815,-2067,0.031084241059056363,366589,127361,
259,0.005597496914200419,10,4591,-4332,4860,25288,16151,519238,0.0196819339623457,239228,823,0.06976093468445618,46184,20,214,0,234,63158,0.02585533850322584,-30033,195,-194,0,0.009357648639806765,195,3351,0,5418,46,-195,8815,-2067,0.031084241059056363,366589,127361,
259,0.002227489505097524,10,4591,-4332,4860,25288,16151,519238,0.0196819339623457,239228,823,0.06976093468445618,46184,83,83,0,166,63158,0.02585533850322584,-30033,78,0,0,0.011591745942066531,78,3351,0,5418,46,-78,8815,-2067,0.031084241059056363,366589,127361,
259,0.0366340967970844,10,4591,-4332,4860,25288,16151,519238,0.0196819339623457,239228,823,0.06976093468445618,46184,17,298,0,315,63158,0.02585533850322584,-30033,295,-281,15,0.03568399245931753,310,3351,0,5418,46,-280,8815,-2067,0.031084241059056363,366589,127361,
259,0.007664335664335664,10,4591,-4332,4860,25288,16151,519238,0.0196819339623457,239228,823,0.06976093468445618,46184,74,360,1,435,63158,0.02585533850322584,-30033,274,-286,0,0.0604642202502695,274,3351,0,5418,46,-274,8815,-2067,0.031084241059056363,366589,127361,
259,0.0035791369718393886,10,4591,-4332,4860,25288,16151,519238,0.0196819339623457,239228,823,0.06976093468445618,46184,41,174,0,215,63158,0.02585533850322584,-30033,152,-133,2,0.01022516146185023,154,3351,0,5418,46,-150,8815,-2067,0.031084241059056363,366589,127361,
259,0.002356202356202356,10,4591,-4332,4860,25288,16151,519238,0.0196819339623457,239228,823,0.06976093468445618,46184,24,90,0,114,63158,0.02585533850322584,-30033,85,-66,0,0.0474102215578395,85,3351,0,5418,46,-85,8815,-2067,0.031084241059056363,366589,127361,
259,0.010351966873706004,10,4591,-4332,4860,25288,16151,519238,0.0196819339623457,239228,823,0.06976093468445618,46184,38,20,0,58,63158,0.02585533850322584,-30033,2,18,3,0.003806175220057044,5,3351,0,5418,46,1,8815,-2067,0.031084241059056363,366589,127361,
259,0.010351966873706004,10,4591,-4332,4860,25288,16151,519238,0.0196819339623457,239228,823,0.06976093468445618,46184,38,20,0,58,63158,0.02585533850322584,-30033,2,18,3,0.003806175220057044,5,3351,0,5418,46,1,8815,-2067,0.031084241059056363,366589,127361,
259,0.010351966873706004,10,4591,-4332,4860,25288,16151,519238,0.0196819339623457,239228,823,0.06976093468445618,46184,38,20,0,58,63158,0.02585533850322584,-30033,2,18,3,0.003806175220057044,5,3351,0,5418,46,1,8815,-2067,0.031084241059056363,366589,127361,
259,0.0,10,4591,-4332,4860,25288,16151,519238,0.0196819339623457,239228,823,0.06976093468445618,46184,391,19,2,412,63158,0.02585533850322584,-30033,0,372,0,0.006813123227224101,0,3351,0,5418,46,0,8815,-2067,0.031084241059056363,366589,127361,
259,0.0,10,4591,-4332,4860,25288,16151,519238,0.0196819339623457,239228,823,0.06976093468445618,46184,391,19,2,412,63158,0.02585533850322584,-30033,0,372,0,0.006813123227224101,0,3351,0,5418,46,0,8815,-2067,0.031084241059056363,366589,127361,
259,0.0,10,4591,-4332,4860,25288,16151,519238,0.0196819339623457,239228,823,0.06976093468445618,46184,391,19,2,412,63158,0.02585533850322584,-30033,0,372,0,0.006813123227224101,0,3351,0,5418,46,0,8815,-2067,0.031084241059056363,366589,127361,
259,0.0,10,4591,-4332,4860,25288,16151,519238,0.0196819339623457,239228,823,0.06976093468445618,46184,391,19,2,412,63158,0.02585533850322584,-30033,0,372,0,0.006813123227224101,0,3351,0,5418,46,0,8815,-2067,0.031084241059056363,366589,127361,
259,0.0,10,4591,-4332,4860,25288,16151,519238,0.0196819339623457,239228,823,0.06976093468445618,46184,391,19,2,412,63158,0.02585533850322584,-30033,0,372,0,0.006813123227224101,0,3351,0,5418,46,0,8815,-2067,0.031084241059056363,366589,127361,
259,0.0,10,4591,-4332,4860,25288,16151,519238,0.0196819339623457,239228,823,0.06976093468445618,46184,391,19,2,412,63158,0.02585533850322584,-30033,0,372,0,0.006813123227224101,0,3351,0,5418,46,0,8815,-2067,0.031084241059056363,366589,127361,
259,0.0,10,4591,-4332,4860,25288,16151,519238,0.0196819339623457,239228,823,0.06976093468445618,46184,391,19,2,412,63158,0.02585533850322584,-30033,0,372,0,0.006813123227224101,0,3351,0,5418,46,0,8815,-2067,0.031084241059056363,366589,127361,
259,0.0044165190136863115,10,4591,-4332,4860,25288,16151,519238,0.0196819339623457,239228,823,0.06976093468445618,46184,322,305,0,627,63158,0.02585533850322584,-30033,293,17,1,0.11046680732905359,294,3351,0,5418,46,-292,8815,-2067,0.031084241059056363,366589,127361,
259,0.0044165190136863115,10,4591,-4332,4860,25288,16151,519238,0.0196819339623457,239228,823,0.06976093468445618,46184,322,305,0,627,63158,0.02585533850322584,-30033,293,17,1,0.11046680732905359,294,3351,0,5418,46,-292,8815,-2067,0.031084241059056363,366589,127361,
259,0.0044165190136863115,10,4591,-4332,4860,25288,16151,519238,0.0196819339623457,239228,823,0.06976093468445618,46184,322,305,0,627,63158,0.02585533850322584,-30033,293,17,1,0.11046680732905359,294,3351,0,5418,46,-292,8815,-2067,0.031084241059056363,366589,127361,
259,0.0044165190136863115,10,4591,-4332,4860,25288,16151,519238,0.0196819339623457,239228,823,0.06976093468445618,46184,322,305,0,627,63158,0.02585533850322584,-30033,293,17,1,0.11046680732905359,294,3351,0,5418,46,-292,8815,-2067,0.031084241059056363,366589,127361,
259,0.0044165190136863115,10,4591,-4332,4860,25288,16151,519238,0.0196819339623457,239228,823,0.06976093468445618,46184,322,305,0,627,63158,0.02585533850322584,-30033,293,17,1,0.11046680732905359,294,3351,0,5418,46,-292,8815,-2067,0.031084241059056363,366589,127361,
259,0.0044165190136863115,10,4591,-4332,4860,25288,16151,519238,0.0196819339623457,239228,823,0.06976093468445618,46184,322,305,0,627,63158,0.02585533850322584,-30033,293,17,1,0.11046680732905359,294,3351,0,5418,46,-292,8815,-2067,0.031084241059056363,366589,127361,
259,0.0044165190136863115,10,4591,-4332,4860,25288,16151,519238,0.0196819339623457,239228,823,0.06976093468445618,46184,322,305,0,627,63158,0.02585533850322584,-30033,293,17,1,0.11046680732905359,294,3351,0,5418,46,-292,8815,-2067,0.031084241059056363,366589,127361,
259,0.005035409429948569,10,4591,-4332,4860,25288,16151,519238,0.0196819339623457,239228,823,0.06976093468445618,46184,19,205,0,224,63158,0.02585533850322584,-30033,187,-186,0,0.005011696158637174,187,3351,0,5418,46,-187,8815,-2067,0.031084241059056363,366589,127361,
259,0.0031641326790550505,10,4591,-4332,4860,25288,16151,519238,0.0196819339623457,239228,823,0.06976093468445618,46184,108,127,0,235,63158,0.02585533850322584,-30033,118,-19,0,0.04799635677911243,118,3351,0,5418,46,-118,8815,-2067,0.031084241059056363,366589,127361,
259,0.05523367441932556,10,4591,-4332,4860,25288,16151,519238,0.0196819339623457,239228,823,0.06976093468445618,46184,560,606,7,1173,63158,0.02585533850322584,-30033,496,-46,22,0.025446064018701205,524,3351,6,5418,46,-474,8815,-2067,0.031084241059056363,366589,127361,
179,0.004430604081219302,1,1713,-1534,1893,25288,16151,519238,0.016317520139969583,239228,823,0.06976093468445618,46184,8,184,0,192,63158,0.02585533850322584,-30033,175,-176,0,0.0023713186227512307,175,1118,0,2163,1,-175,3282,-1045,0.026581340994143967,366589,127361,
179,0.004430604081219302,1,1713,-1534,1893,25288,16151,519238,0.016317520139969583,239228,823,0.06976093468445618,46184,8,184,0,192,63158,0.02585533850322584,-30033,175,-176,0,0.0023713186227512307,175,1118,0,2163,1,-175,3282,-1045,0.026581340994143967,366589,127361,
179,0.003375569942313021,1,1713,-1534,1893,25288,16151,519238,0.016317520139969583,239228,823,0.06976093468445618,46184,151,280,0,431,63158,0.02585533850322584,-30033,134,-129,0,0.008944452615801358,134,1118,0,2163,1,-134,3282,-1045,0.026581340994143967,366589,127361,
179,0.003375569942313021,1,1713,-1534,1893,25288,16151,519238,0.016317520139969583,239228,823,0.06976093468445618,46184,151,280,0,431,63158,0.02585533850322584,-30033,134,-129,0,0.008944452615801358,134,1118,0,2163,1,-134,3282,-1045,0.026581340994143967,366589,127361,
179,0.003375569942313021,1,1713,-1534,1893,25288,16151,519238,0.016317520139969583,239228,823,0.06976093468445618,46184,151,280,0,431,63158,0.02585533850322584,-30033,134,-129,0,0.008944452615801358,134,1118,0,2163,1,-134,3282,-1045,0.026581340994143967,366589,127361,
179,0.003375569942313021,1,1713,-1534,1893,25288,16151,519238,0.016317520139969583,239228,823,0.06976093468445618,46184,151,280,0,431,63158,0.02585533850322584,-30033,134,-129,0,0.008944452615801358,134,1118,0,2163,1,-134,3282,-1045,0.026581340994143967,366589,127361,
179,0.0032753275327532753,1,1713,-1534,1893,25288,16151,519238,0.016317520139969583,239228,823,0.06976093468445618,46184,5,137,0,142,63158,0.02585533850322584,-30033,131,-132,0,0.0015760744952898022,131,1118,0,2163,1,-131,3282,-1045,0.026581340994143967,366589,127361,
179,0.0032753275327532753,1,1713,-1534,1893,25288,16151,519238,0.016317520139969583,239228,823,0.06976093468445618,46184,5,137,0,142,63158,0.02585533850322584,-30033,131,-132,0,0.0015760744952898022,131,1118,0,2163,1,-131,3282,-1045,0.026581340994143967,366589,127361,
179,0.0036070549018632305,1,1713,-1534,1893,25288,16151,519238,0.016317520139969583,239228,823,0.06976093468445618,46184,153,153,0,306,63158,0.02585533850322584,-30033,145,0,0,0.07223210319576322,145,1118,0,2163,1,-145,3282,-1045,0.026581340994143967,366589,127361,
179,0.003292079207920792,1,1713,-1534,1893,25288,16151,519238,0.016317520139969583,239228,823,0.06976093468445618,46184,149,279,0,428,63158,0.02585533850322584,-30033,133,-130,0,0.008001986624825841,133,1118,0,2163,1,-133,3282,-1045,0.026581340994143967,366589,127361,
179,0.003292079207920792,1,1713,-1534,1893,25288,16151,519238,0.016317520139969583,239228,823,0.06976093468445618,46184,149,279,0,428,63158,0.02585533850322584,-30033,133,-130,0,0.008001986624825841,133,1118,0,2163,1,-133,3282,-1045,0.026581340994143967,366589,127361,
179,0.003292079207920792,1,1713,-1534,1893,25288,16151,519238,0.016317520139969583,239228,823,0.06976093468445618,46184,149,279,0,428,63158,0.02585533850322584,-30033,133,-130,0,0.008001986624825841,133,1118,0,2163,1,-133,3282,-1045,0.026581340994143967,366589,127361,
179,0.003292079207920792,1,1713,-1534,1893,25288,16151,519238,0.016317520139969583,239228,823,0.06976093468445618,46184,149,279,0,428,63158,0.02585533850322584,-30033,133,-130,0,0.008001986624825841,133,1118,0,2163,1,-133,3282,-1045,0.026581340994143967,366589,127361,
4,0.0028688126033258776,0,1332,-1328,1336,25288,16151,519238,0.01083609017871198,239228,823,0.06976093468445618,46184,31,129,2,162,63158,0.02585533850322584,-30033,118,-98,0,0.10435460892617937,118,368,0,1464,9,-118,1841,-1096,0.0469778514090829,366589,127361,
4,0.007705662710776036,0,1332,-1328,1336,25288,16151,519238,0.01083609017871198,239228,823,0.06976093468445618,46184,48,357,3,408,63158,0.02585533850322584,-30033,324,-309,0,0.06843544880232977,324,368,0,1464,9,-324,1841,-1096,0.0469778514090829,366589,127361,
4,0.007705662710776036,0,1332,-1328,1336,25288,16151,519238,0.01083609017871198,239228,823,0.06976093468445618,46184,48,357,3,408,63158,0.02585533850322584,-30033,324,-309,0,0.06843544880232977,324,368,0,1464,9,-324,1841,-1096,0.0469778514090829,366589,127361,
4,0.007705662710776036,0,1332,-1328,1336,25288,16151,519238,0.01083609017871198,239228,823,0.06976093468445618,46184,48,357,3,408,63158,0.02585533850322584,-30033,324,-309,0,0.06843544880232977,324,368,0,1464,9,-324,1841,-1096,0.0469778514090829,366589,127361,
4,0.10174392571819103,0,1332,-1328,1336,25288,16151,519238,0.01083609017871198,239228,823,0.06976093468445618,46184,79,158,0,237,63158,0.02585533850322584,-30033,152,-79,4,0.11470297560137412,156,368,0,1464,9,-148,1841,-1096,0.0469778514090829,366589,127361,
47,0.06646783942694945,0,1188,-1141,1235,25288,16151,519238,0.06646783942694945,239228,823,0.06976093468445618,46184,674,1354,21,2049,63158,0.02585533850322584,-30033,1188,-680,47,0.20409641554922212,1235,674,0,1354,21,-1141,2049,-680,0.20409641554922212,366589,127361,
47,0.06646783942694945,0,1188,-1141,1235,25288,16151,519238,0.06646783942694945,239228,823,0.06976093468445618,46184,674,1354,21,2049,63158,0.02585533850322584,-30033,1188,-680,47,0.20409641554922212,1235,674,0,1354,21,-1141,2049,-680,0.20409641554922212,366589,127361,
47,0.06646783942694945,0,1188,-1141,1235,25288,16151,519238,0.06646783942694945,239228,823,0.06976093468445618,46184,674,1354,21,2049,63158,0.02585533850322584,-30033,1188,-680,47,0.20409641554922212,1235,674,0,1354,21,-1141,2049,-680,0.20409641554922212,366589,127361,
47,0.06646783942694945,0,1188,-1141,1235,25288,16151,519238,0.06646783942694945,239228,823,0.06976093468445618,46184,674,1354,21,2049,63158,0.02585533850322584,-30033,1188,-680,47,0.20409641554922212,1235,674,0,1354,21,-1141,2049,-680,0.20409641554922212,366589,127361,
47,0.06646783942694945,0,1188,-1141,1235,25288,16151,519238,0.06646783942694945,239228,823,0.06976093468445618,46184,674,1354,21,2049,63158,0.02585533850322584,-30033,1188,-680,47,0.20409641554922212,1235,674,0,1354,21,-1141,2049,-680,0.20409641554922212,366589,127361,
47,0.06646783942694945,0,1188,-1141,1235,25288,16151,519238,0.06646783942694945,239228,823,0.06976093468445618,46184,674,1354,21,2049,63158,0.02585533850322584,-30033,1188,-680,47,0.20409641554922212,1235,674,0,1354,21,-1141,2049,-680,0.20409641554922212,366589,127361,
47,0.06646783942694945,0,1188,-1141,1235,25288,16151,519238,0.06646783942694945,239228,823,0.06976093468445618,46184,674,1354,21,2049,63158,0.02585533850322584,-30033,1188,-680,47,0.20409641554922212,1235,674,0,1354,21,-1141,2049,-680,0.20409641554922212,366589,127361,
47,0.06646783942694945,0,1188,-1141,1235,25288,16151,519238,0.06646783942694945,239228,823,0.06976093468445618,46184,674,1354,21,2049,63158,0.02585533850322584,-30033,1188,-680,47,0.20409641554922212,1235,674,0,1354,21,-1141,2049,-680,0.20409641554922212,366589,127361,
47,0.06646783942694945,0,1188,-1141,1235,25288,16151,519238,0.06646783942694945,239228,823,0.06976093468445618,46184,674,1354,21,2049,63158,0.02585533850322584,-30033,1188,-680,47,0.20409641554922212,1235,674,0,1354,21,-1141,2049,-680,0.20409641554922212,366589,127361,
47,0.06646783942694945,0,1188,-1141,1235,25288,16151,519238,0.06646783942694945,239228,823,0.06976093468445618,46184,674,1354,21,2049,63158,0.02585533850322584,-30033,1188,-680,47,0.20409641554922212,1235,674,0,1354,21,-1141,2049,-680,0.20409641554922212,366589,127361,
47,0.06646783942694945,0,1188,-1141,1235,25288,16151,519238,0.06646783942694945,239228,823,0.06976093468445618,46184,674,1354,21,2049,63158,0.02585533850322584,-30033,1188,-680,47,0.20409641554922212,1235,674,0,1354,21,-1141,2049,-680,0.20409641554922212,366589,127361,
47,0.06646783942694945,0,1188,-1141,1235,25288,16151,519238,0.06646783942694945,239228,823,0.06976093468445618,46184,674,1354,21,2049,63158,0.02585533850322584,-30033,1188,-680,47,0.20409641554922212,1235,674,0,1354,21,-1141,2049,-680,0.20409641554922212,366589,127361,
47,0.06646783942694945,0,1188,-1141,1235,25288,16151,519238,0.06646783942694945,239228,823,0.06976093468445618,46184,674,1354,21,2049,63158,0.02585533850322584,-30033,1188,-680,47,0.20409641554922212,1235,674,0,1354,21,-1141,2049,-680,0.20409641554922212,366589,127361,
47,0.06646783942694945,0,1188,-1141,1235,25288,16151,519238,0.06646783942694945,239228,823,0.06976093468445618,46184,674,1354,21,2049,63158,0.02585533850322584,-30033,1188,-680,47,0.20409641554922212,1235,674,0,1354,21,-1141,2049,-680,0.20409641554922212,366589,127361,
47,0.06646783942694945,0,1188,-1141,1235,25288,16151,519238,0.06646783942694945,239228,823,0.06976093468445618,46184,674,1354,21,2049,63158,0.02585533850322584,-30033,1188,-680,47,0.20409641554922212,1235,674,0,1354,21,-1141,2049,-680,0.20409641554922212,366589,127361,
47,0.06646783942694945,0,1188,-1141,1235,25288,16151,519238,0.06646783942694945,239228,823,0.06976093468445618,46184,674,1354,21,2049,63158,0.02585533850322584,-30033,1188,-680,47,0.20409641554922212,1235,674,0,1354,21,-1141,2049,-680,0.20409641554922212,366589,127361,
47,0.06646783942694945,0,1188,-1141,1235,25288,16151,519238,0.06646783942694945,239228,823,0.06976093468445618,46184,674,1354,21,2049,63158,0.02585533850322584,-30033,1188,-680,47,0.20409641554922212,1235,674,0,1354,21,-1141,2049,-680,0.20409641554922212,366589,127361,
47,0.06646783942694945,0,1188,-1141,1235,25288,16151,519238,0.06646783942694945,239228,823,0.06976093468445618,46184,674,1354,21,2049,63158,0.02585533850322584,-30033,1188,-680,47,0.20409641554922212,1235,674,0,1354,21,-1141,2049,-680,0.20409641554922212,366589,127361,
47,0.06646783942694945,0,1188,-1141,1235,25288,16151,519238,0.06646783942694945,239228,823,0.06976093468445618,46184,674,1354,21,2049,63158,0.02585533850322584,-30033,1188,-680,47,0.20409641554922212,1235,674,0,1354,21,-1141,2049,-680,0.20409641554922212,366589,127361,
0,0.006007830430673687,0,267,-267,267,25288,16151,519238,0.006007830430673687,239228,823,0.06976093468445618,46184,236,331,2,569,63158,0.02585533850322584,-30033,267,-95,0,0.09619327342851103,267,236,0,331,2,-267,569,-95,0.09619327342851103,366589,127361,
0,0.0038237959463342398,0,867,-867,867,25288,16151,519238,0.003833070064757166,239228,823,0.06976093468445618,46184,113,177,1,291,63158,0.02585533850322584,-30033,173,-64,0,0.13716814927552337,173,773,0,934,8,-173,1715,-161,0.15951134317362453,366589,127361,
0,0.0038237959463342398,0,867,-867,867,25288,16151,519238,0.003833070064757166,239228,823,0.06976093468445618,46184,113,177,1,291,63158,0.02585533850322584,-30033,173,-64,0,0.13716814927552337,173,773,0,934,8,-173,1715,-161,0.15951134317362453,366589,127361,
0,0.0038237959463342398,0,867,-867,867,25288,16151,519238,0.003833070064757166,239228,823,0.06976093468445618,46184,113,177,1,291,63158,0.02585533850322584,-30033,173,-64,0,0.13716814927552337,173,773,0,934,8,-173,1715,-161,0.15951134317362453,366589,127361,
0,0.0038237959463342398,0,867,-867,867,25288,16151,519238,0.003833070064757166,239228,823,0.06976093468445618,46184,113,177,1,291,63158,0.02585533850322584,-30033,173,-64,0,0.13716814927552337,173,773,0,934,8,-173,1715,-161,0.15951134317362453,366589,127361,
0,0.005248655032148012,0,867,-867,867,25288,16151,519238,0.003833070064757166,239228,823,0.06976093468445618,46184,300,250,1,551,63158,0.02585533850322584,-30033,240,50,0,0.1499153042849407,240,773,0,934,8,-240,1715,-161,0.15951134317362453,366589,127361,
0,0.0014365939663053414,0,122,-122,122,25288,16151,519238,0.0013294371961786878,239228,823,0.06976093468445618,46184,57,66,0,123,63158,0.02585533850322584,-30033,66,-9,0,0.1472663649864217,66,58,0,123,0,-66,181,-65,0.09605911811977508,366589,127361,
0,0.0024056695780325524,0,875,-875,875,25288,16151,519238,0.003745474759417615,239228,823,0.06976093468445618,46184,0,111,0,111,63158,0.02585533850322584,-30033,111,-111,0,0.0012028347890162762,111,679,0,1251,32,-111,1962,-572,0.056951727722208446,366589,127361,
0,0.00797556422874597,0,875,-875,875,25288,16151,519238,0.003745474759417615,239228,823,0.06976093468445618,46184,520,711,26,1257,63158,0.02585533850322584,-30033,376,-191,0,0.07909286873290486,376,679,0,1251,32,-376,1962,-572,0.056951727722208446,366589,127361,
0,0.00797556422874597,0,875,-875,875,25288,16151,519238,0.003745474759417615,239228,823,0.06976093468445618,46184,520,711,26,1257,63158,0.02585533850322584,-30033,376,-191,0,0.07909286873290486,376,679,0,1251,32,-376,1962,-572,0.056951727722208446,366589,127361,
0,0.00797556422874597,0,875,-875,875,25288,16151,519238,0.003745474759417615,239228,823,0.06976093468445618,46184,520,711,26,1257,63158,0.02585533850322584,-30033,376,-191,0,0.07909286873290486,376,679,0,1251,32,-376,1962,-572,0.056951727722208446,366589,127361,
0,0.0052449761974975775,0,2727,-2727,2727,25288,16151,519238,0.004263129028920998,239228,823,0.06976093468445618,46184,445,273,1,719,63158,0.02585533850322584,-30033,249,172,0,0.0602676287783364,249,3364,0,3893,106,-249,7363,-529,0.036424699420694755,366589,127361,
0,0.0052449761974975775,0,2727,-2727,2727,25288,16151,519238,0.004263129028920998,239228,823,0.06976093468445618,46184,445,273,1,719,63158,0.02585533850322584,-30033,249,172,0,0.0602676287783364,249,3364,0,3893,106,-249,7363,-529,0.036424699420694755,366589,127361,
0,0.0052449761974975775,0,2727,-2727,2727,25288,16151,519238,0.004263129028920998,239228,823,0.06976093468445618,46184,445,273,1,719,63158,0.02585533850322584,-30033,249,172,0,0.0602676287783364,249,3364,0,3893,106,-249,7363,-529,0.036424699420694755,366589,127361,
0,0.002476650225627033,0,2727,-2727,2727,25288,16151,519238,0.004263129028920998,239228,823,0.06976093468445618,46184,296,273,3,572,63158,0.02585533850322584,-30033,118,23,0,0.01147920534039524,118,3364,0,3893,106,-118,7363,-529,0.036424699420694755,366589,127361,
0,0.022031525774450732,0,2727,-2727,2727,25288,16151,519238,0.004263129028920998,239228,823,0.06976093468445618,46184,1003,1204,76,2283,63158,0.02585533850322584,-30033,1086,-201,0,0.08319974628831636,1086,3364,0,3893,106,-1086,7363,-529,0.036424699420694755,366589,127361,
0,0.022031525774450732,0,2727,-2727,2727,25288,16151,519238,0.004263129028920998,239228,823,0.06976093468445618,46184,1003,1204,76,2283,63158,0.02585533850322584,-30033,1086,-201,0,0.08319974628831636,1086,3364,0,3893,106,-1086,7363,-529,0.036424699420694755,366589,127361,
0,0.003412624692056056,0,2727,-2727,2727,25288,16151,519238,0.004263129028920998,239228,823,0.06976093468445618,46184,226,212,2,440,63158,0.02585533850322584,-30033,169,14,0,0.03970475760721119,169,3364,0,3893,106,-169,7363,-529,0.036424699420694755,366589,127361,
0,0.003412624692056056,0,2727,-2727,2727,25288,16151,519238,0.004263129028920998,239228,823,0.06976093468445618,46184,226,212,2,440,63158,0.02585533850322584,-30033,169,14,0,0.03970475760721119,169,3364,0,3893,106,-169,7363,-529,0.036424699420694755,366589,127361,
0,0.003412624692056056,0,2727,-2727,2727,25288,16151,519238,0.004263129028920998,239228,823,0.06976093468445618,46184,226,212,2,440,63158,0.02585533850322584,-30033,169,14,0,0.03970475760721119,169,3364,0,3893,106,-169,7363,-529,0.036424699420694755,366589,127361,
0,0.003412624692056056,0,2727,-2727,2727,25288,16151,519238,0.004263129028920998,239228,823,0.06976093468445618,46184,226,212,2,440,63158,0.02585533850322584,-30033,169,14,0,0.03970475760721119,169,3364,0,3893,106,-169,7363,-529,0.036424699420694755,366589,127361,
0,0.004357079752630311,0,2727,-2727,2727,25288,16151,519238,0.004263129028920998,239228,823,0.06976093468445618,46184,398,475,1,874,63158,0.02585533850322584,-30033,217,-77,0,0.02775387613532915,217,3364,0,3893,106,-217,7363,-529,0.036424699420694755,366589,127361,
0,0.004357079752630311,0,2727,-2727,2727,25288,16151,519238,0.004263129028920998,239228,823,0.06976093468445618,46184,398,475,1,874,63158,0.02585533850322584,-30033,217,-77,0,0.02775387613532915,217,3364,0,3893,106,-217,7363,-529,0.036424699420694755,366589,127361,
0,0.005976571838393498,0,2727,-2727,2727,25288,16151,519238,0.004263129028920998,239228,823,0.06976093468445618,46184,144,374,16,534,63158,0.02585533850322584,-30033,300,-230,0,0.05396658106186877,300,3364,0,3893,106,-300,7363,-529,0.036424699420694755,366589,127361,
0,0.001686574864081908,0,2727,-2727,2727,25288,16151,519238,0.004263129028920998,239228,823,0.06976093468445618,46184,128,190,4,322,63158,0.02585533850322584,-30033,85,-62,0,0.0020941640489788938,85,3364,0,3893,106,-85,7363,-529,0.036424699420694755,366589,127361,
0,0.001686574864081908,0,2727,-2727,2727,25288,16151,519238,0.004263129028920998,239228,823,0.06976093468445618,46184,128,190,4,322,63158,0.02585533850322584,-30033,85,-62,0,0.0020941640489788938,85,3364,0,3893,106,-85,7363,-529,0.036424699420694755,366589,127361,
0,0.0037314906219151037,0,2727,-2727,2727,25288,16151,519238,0.004263129028920998,239228,823,0.06976093468445618,46184,364,423,2,789,63158,0.02585533850322584,-30033,189,-59,0,0.01454237574779775,189,3364,0,3893,106,-189,7363,-529,0.036424699420694755,366589,127361,
0,6.507078913120637E-4,0,33,-33,33,25288,16151,519238,6.507078913120637E-4,239228,823,0.06976093468445618,46184,0,75,0,75,63158,0.02585533850322584,-30033,33,-75,0,0.001590757123385,33,0,0,75,0,-33,75,-75,0.001590757123385,366589,127361,
32,0.14899365434385514,7,984,-952,1023,25288,16151,519238,0.03327269335793451,239228,823,0.06976093468445618,46184,154,115,12,281,63158,0.02585533850322584,-30033,87,39,32,0.03754741548103482,126,880,7,1034,16,-55,1930,-154,0.05844929473586026,366589,127361,
32,0.14899365434385514,7,984,-952,1023,25288,16151,519238,0.03327269335793451,239228,823,0.06976093468445618,46184,154,115,12,281,63158,0.02585533850322584,-30033,87,39,32,0.03754741548103482,126,880,7,1034,16,-55,1930,-154,0.05844929473586026,366589,127361,
32,0.14899365434385514,7,984,-952,1023,25288,16151,519238,0.03327269335793451,239228,823,0.06976093468445618,46184,154,115,12,281,63158,0.02585533850322584,-30033,87,39,32,0.03754741548103482,126,880,7,1034,16,-55,1930,-154,0.05844929473586026,366589,127361,
32,0.14899365434385514,7,984,-952,1023,25288,16151,519238,0.03327269335793451,239228,823,0.06976093468445618,46184,154,115,12,281,63158,0.02585533850322584,-30033,87,39,32,0.03754741548103482,126,880,7,1034,16,-55,1930,-154,0.05844929473586026,366589,127361,
32,0.14899365434385514,7,984,-952,1023,25288,16151,519238,0.03327269335793451,239228,823,0.06976093468445618,46184,154,115,12,281,63158,0.02585533850322584,-30033,87,39,32,0.03754741548103482,126,880,7,1034,16,-55,1930,-154,0.05844929473586026,366589,127361,
32,0.010337365227808478,7,984,-952,1023,25288,16151,519238,0.03327269335793451,239228,823,0.06976093468445618,46184,584,547,1,1132,63158,0.02585533850322584,-30033,535,37,0,0.07623542913725215,535,880,0,1034,16,-535,1930,-154,0.05844929473586026,366589,127361,
32,0.010337365227808478,7,984,-952,1023,25288,16151,519238,0.03327269335793451,239228,823,0.06976093468445618,46184,584,547,1,1132,63158,0.02585533850322584,-30033,535,37,0,0.07623542913725215,535,880,0,1034,16,-535,1930,-154,0.05844929473586026,366589,127361,
8,0.030219488641320673,6,66,-58,80,25288,16151,519238,0.010073162880440224,239228,823,0.06976093468445618,46184,81,87,6,174,63158,0.02585533850322584,-30033,66,-6,8,0.02893222520517632,80,92,6,95,8,-58,195,-3,0.014096069103984468,366589,127361,
1,0.002831072938385906,0,817,-816,818,25288,16151,519238,0.0025981592575046245,239228,823,0.06976093468445618,46184,61,149,0,210,63158,0.02585533850322584,-30033,148,-88,0,0.11397051090283361,148,635,0,1095,17,-148,1747,-460,0.08219996597074512,366589,127361,
1,0.002831072938385906,0,817,-816,818,25288,16151,519238,0.0025981592575046245,239228,823,0.06976093468445618,46184,61,149,0,210,63158,0.02585533850322584,-30033,148,-88,0,0.11397051090283361,148,635,0,1095,17,-148,1747,-460,0.08219996597074512,366589,127361,
1,0.002831072938385906,0,817,-816,818,25288,16151,519238,0.0025981592575046245,239228,823,0.06976093468445618,46184,61,149,0,210,63158,0.02585533850322584,-30033,148,-88,0,0.11397051090283361,148,635,0,1095,17,-148,1747,-460,0.08219996597074512,366589,127361,
1,0.0011076946582380016,0,817,-816,818,25288,16151,519238,0.0025981592575046245,239228,823,0.06976093468445618,46184,15,59,0,74,63158,0.02585533850322584,-30033,58,-44,0,0.07625312841857895,58,635,0,1095,17,-58,1747,-460,0.08219996597074512,366589,127361,
1,0.0011076946582380016,0,817,-816,818,25288,16151,519238,0.0025981592575046245,239228,823,0.06976093468445618,46184,15,59,0,74,63158,0.02585533850322584,-30033,58,-44,0,0.07625312841857895,58,635,0,1095,17,-58,1747,-460,0.08219996597074512,366589,127361,
1,0.0020942807097707712,0,817,-816,818,25288,16151,519238,0.0025981592575046245,239228,823,0.06976093468445618,46184,7,226,1,234,63158,0.02585533850322584,-30033,110,-219,0,0.03462483804311346,110,635,0,1095,17,-110,1747,-460,0.08219996597074512,366589,127361,
1,0.003345873945235446,0,817,-816,818,25288,16151,519238,0.0025981592575046245,239228,823,0.06976093468445618,46184,320,429,16,765,63158,0.02585533850322584,-30033,309,-109,1,0.0666196664086201,310,635,0,1095,17,-308,1747,-460,0.08219996597074512,366589,127361,
1,0.003345873945235446,0,817,-816,818,25288,16151,519238,0.0025981592575046245,239228,823,0.06976093468445618,46184,320,429,16,765,63158,0.02585533850322584,-30033,309,-109,1,0.0666196664086201,310,635,0,1095,17,-308,1747,-460,0.08219996597074512,366589,127361,
1,0.003345873945235446,0,817,-816,818,25288,16151,519238,0.0025981592575046245,239228,823,0.06976093468445618,46184,320,429,16,765,63158,0.02585533850322584,-30033,309,-109,1,0.0666196664086201,310,635,0,1095,17,-308,1747,-460,0.08219996597074512,366589,127361,
1,0.003345873945235446,0,817,-816,818,25288,16151,519238,0.0025981592575046245,239228,823,0.06976093468445618,46184,320,429,16,765,63158,0.02585533850322584,-30033,309,-109,1,0.0666196664086201,310,635,0,1095,17,-308,1747,-460,0.08219996597074512,366589,127361,
1,0.003345873945235446,0,817,-816,818,25288,16151,519238,0.0025981592575046245,239228,823,0.06976093468445618,46184,320,429,16,765,63158,0.02585533850322584,-30033,309,-109,1,0.0666196664086201,310,635,0,1095,17,-308,1747,-460,0.08219996597074512,366589,127361,
1,0.003345873945235446,0,817,-816,818,25288,16151,519238,0.0025981592575046245,239228,823,0.06976093468445618,46184,320,429,16,765,63158,0.02585533850322584,-30033,309,-109,1,0.0666196664086201,310,635,0,1095,17,-308,1747,-460,0.08219996597074512,366589,127361,
1,0.003345873945235446,0,817,-816,818,25288,16151,519238,0.0025981592575046245,239228,823,0.06976093468445618,46184,320,429,16,765,63158,0.02585533850322584,-30033,309,-109,1,0.0666196664086201,310,635,0,1095,17,-308,1747,-460,0.08219996597074512,366589,127361,
1,0.003345873945235446,0,817,-816,818,25288,16151,519238,0.0025981592575046245,239228,823,0.06976093468445618,46184,320,429,16,765,63158,0.02585533850322584,-30033,309,-109,1,0.0666196664086201,310,635,0,1095,17,-308,1747,-460,0.08219996597074512,366589,127361,
1,0.003345873945235446,0,817,-816,818,25288,16151,519238,0.0025981592575046245,239228,823,0.06976093468445618,46184,320,429,16,765,63158,0.02585533850322584,-30033,309,-109,1,0.0666196664086201,310,635,0,1095,17,-308,1747,-460,0.08219996597074512,366589,127361,
1,0.003345873945235446,0,817,-816,818,25288,16151,519238,0.0025981592575046245,239228,823,0.06976093468445618,46184,320,429,16,765,63158,0.02585533850322584,-30033,309,-109,1,0.0666196664086201,310,635,0,1095,17,-308,1747,-460,0.08219996597074512,366589,127361,
1,0.0036118740358929984,0,817,-816,818,25288,16151,519238,0.0025981592575046245,239228,823,0.06976093468445618,46184,232,232,0,464,63158,0.02585533850322584,-30033,192,0,0,0.11953168608057954,192,635,0,1095,17,-192,1747,-460,0.08219996597074512,366589,127361,
17,0.024566473988439308,0,0,17,17,25288,16151,519238,0.024566473988439308,239228,823,0.06976093468445618,46184,838,93,2,933,63158,0.02585533850322584,-30033,0,745,17,0.11572329104234758,17,838,0,93,2,17,933,745,0.11572329104234758,366589,127361,
0,0.0,0,0,0,0,25288,16151,519238,0.0,239228,823,0.06976093468445618,46184,311,105,2,418,63158,0.02585533850322584,-30033,0,206,0,0.07034187211426171,0,311,0,105,2,0,418,206,0.07034187211426171,366589,127361,
0,0.0,0,0,0,0,25288,16151,519238,0.0,239228,823,0.06976093468445618,46184,311,105,2,418,63158,0.02585533850322584,-30033,0,206,0,0.07034187211426171,0,311,0,105,2,0,418,206,0.07034187211426171,366589,127361,
0,0.0,0,0,0,0,25288,16151,519238,0.0,239228,823,0.06976093468445618,46184,311,105,2,418,63158,0.02585533850322584,-30033,0,206,0,0.07034187211426171,0,311,0,105,2,0,418,206,0.07034187211426171,366589,127361,
0,0.0,0,0,0,0,25288,16151,519238,0.0,239228,823,0.06976093468445618,46184,311,105,2,418,63158,0.02585533850322584,-30033,0,206,0,0.07034187211426171,0,311,0,105,2,0,418,206,0.07034187211426171,366589,127361,
0,0.0,0,0,0,0,25288,16151,519238,0.0,239228,823,0.06976093468445618,46184,311,105,2,418,63158,0.02585533850322584,-30033,0,206,0,0.07034187211426171,0,311,0,105,2,0,418,206,0.07034187211426171,366589,127361,
0,0.0,0,0,0,0,25288,16151,519238,0.0,239228,823,0.06976093468445618,46184,311,105,2,418,63158,0.02585533850322584,-30033,0,206,0,0.07034187211426171,0,311,0,105,2,0,418,206,0.07034187211426171,366589,127361,
0,0.0,0,265,-265,265,25288,16151,519238,8.255760339950404E-4,239228,823,0.06976093468445618,46184,408,11,5,424,63158,0.02585533850322584,-30033,0,397,0,0.02321740634509841,0,1358,0,622,18,0,1998,736,0.07082895072108805,366589,127361,
0,0.0,0,265,-265,265,25288,16151,519238,8.255760339950404E-4,239228,823,0.06976093468445618,46184,408,11,5,424,63158,0.02585533850322584,-30033,0,397,0,0.02321740634509841,0,1358,0,622,18,0,1998,736,0.07082895072108805,366589,127361,
0,0.0,0,265,-265,265,25288,16151,519238,8.255760339950404E-4,239228,823,0.06976093468445618,46184,408,11,5,424,63158,0.02585533850322584,-30033,0,397,0,0.02321740634509841,0,1358,0,622,18,0,1998,736,0.07082895072108805,366589,127361,
0,0.0,0,265,-265,265,25288,16151,519238,8.255760339950404E-4,239228,823,0.06976093468445618,46184,408,11,5,424,63158,0.02585533850322584,-30033,0,397,0,0.02321740634509841,0,1358,0,622,18,0,1998,736,0.07082895072108805,366589,127361,
0,0.0,0,265,-265,265,25288,16151,519238,8.255760339950404E-4,239228,823,0.06976093468445618,46184,408,11,5,424,63158,0.02585533850322584,-30033,0,397,0,0.02321740634509841,0,1358,0,622,18,0,1998,736,0.07082895072108805,366589,127361,
0,0.0,0,265,-265,265,25288,16151,519238,8.255760339950404E-4,239228,823,0.06976093468445618,46184,408,11,5,424,63158,0.02585533850322584,-30033,0,397,0,0.02321740634509841,0,1358,0,622,18,0,1998,736,0.07082895072108805,366589,127361,
0,0.0,0,265,-265,265,25288,16151,519238,8.255760339950404E-4,239228,823,0.06976093468445618,46184,408,11,5,424,63158,0.02585533850322584,-30033,0,397,0,0.02321740634509841,0,1358,0,622,18,0,1998,736,0.07082895072108805,366589,127361,
0,0.0,0,265,-265,265,25288,16151,519238,8.255760339950404E-4,239228,823,0.06976093468445618,46184,408,11,5,424,63158,0.02585533850322584,-30033,0,397,0,0.02321740634509841,0,1358,0,622,18,0,1998,736,0.07082895072108805,366589,127361,
0,0.004953456203970242,0,265,-265,265,25288,16151,519238,8.255760339950404E-4,239228,823,0.06976093468445618,46184,278,584,10,872,63158,0.02585533850322584,-30033,265,-306,0,0.020404433366495226,265,1358,0,622,18,-265,1998,736,0.07082895072108805,366589,127361,
0,0.004953456203970242,0,265,-265,265,25288,16151,519238,8.255760339950404E-4,239228,823,0.06976093468445618,46184,278,584,10,872,63158,0.02585533850322584,-30033,265,-306,0,0.020404433366495226,265,1358,0,622,18,-265,1998,736,0.07082895072108805,366589,127361,
0,0.004953456203970242,0,265,-265,265,25288,16151,519238,8.255760339950404E-4,239228,823,0.06976093468445618,46184,278,584,10,872,63158,0.02585533850322584,-30033,265,-306,0,0.020404433366495226,265,1358,0,622,18,-265,1998,736,0.07082895072108805,366589,127361,
0,0.004953456203970242,0,265,-265,265,25288,16151,519238,8.255760339950404E-4,239228,823,0.06976093468445618,46184,278,584,10,872,63158,0.02585533850322584,-30033,265,-306,0,0.020404433366495226,265,1358,0,622,18,-265,1998,736,0.07082895072108805,366589,127361,
0,0.004953456203970242,0,265,-265,265,25288,16151,519238,8.255760339950404E-4,239228,823,0.06976093468445618,46184,278,584,10,872,63158,0.02585533850322584,-30033,265,-306,0,0.020404433366495226,265,1358,0,622,18,-265,1998,736,0.07082895072108805,366589,127361,
0,0.004953456203970242,0,265,-265,265,25288,16151,519238,8.255760339950404E-4,239228,823,0.06976093468445618,46184,278,584,10,872,63158,0.02585533850322584,-30033,265,-306,0,0.020404433366495226,265,1358,0,622,18,-265,1998,736,0.07082895072108805,366589,127361,
0,0.004953456203970242,0,265,-265,265,25288,16151,519238,8.255760339950404E-4,239228,823,0.06976093468445618,46184,278,584,10,872,63158,0.02585533850322584,-30033,265,-306,0,0.020404433366495226,265,1358,0,622,18,-265,1998,736,0.07082895072108805,366589,127361,
0,0.0,0,265,-265,265,25288,16151,519238,8.255760339950404E-4,239228,823,0.06976093468445618,46184,159,0,1,160,63158,0.02585533850322584,-30033,0,159,0,0.06717044500419815,0,1358,0,622,18,0,1998,736,0.07082895072108805,366589,127361,
0,0.0,0,265,-265,265,25288,16151,519238,8.255760339950404E-4,239228,823,0.06976093468445618,46184,159,0,1,160,63158,0.02585533850322584,-30033,0,159,0,0.06717044500419815,0,1358,0,622,18,0,1998,736,0.07082895072108805,366589,127361,
0,0.0,0,265,-265,265,25288,16151,519238,8.255760339950404E-4,239228,823,0.06976093468445618,46184,159,0,1,160,63158,0.02585533850322584,-30033,0,159,0,0.06717044500419815,0,1358,0,622,18,0,1998,736,0.07082895072108805,366589,127361,
0,0.0,0,265,-265,265,25288,16151,519238,8.255760339950404E-4,239228,823,0.06976093468445618,46184,159,0,1,160,63158,0.02585533850322584,-30033,0,159,0,0.06717044500419815,0,1358,0,622,18,0,1998,736,0.07082895072108805,366589,127361,
0,0.0,0,265,-265,265,25288,16151,519238,8.255760339950404E-4,239228,823,0.06976093468445618,46184,159,0,1,160,63158,0.02585533850322584,-30033,0,159,0,0.06717044500419815,0,1358,0,622,18,0,1998,736,0.07082895072108805,366589,127361,
0,0.0,0,265,-265,265,25288,16151,519238,8.255760339950404E-4,239228,823,0.06976093468445618,46184,159,0,1,160,63158,0.02585533850322584,-30033,0,159,0,0.06717044500419815,0,1358,0,622,18,0,1998,736,0.07082895072108805,366589,127361,
0,0.0,0,265,-265,265,25288,16151,519238,8.255760339950404E-4,239228,823,0.06976093468445618,46184,159,0,1,160,63158,0.02585533850322584,-30033,0,159,0,0.06717044500419815,0,1358,0,622,18,0,1998,736,0.07082895072108805,366589,127361,
0,0.0,0,265,-265,265,25288,16151,519238,8.255760339950404E-4,239228,823,0.06976093468445618,46184,159,0,1,160,63158,0.02585533850322584,-30033,0,159,0,0.06717044500419815,0,1358,0,622,18,0,1998,736,0.07082895072108805,366589,127361,
0,0.0,0,265,-265,265,25288,16151,519238,8.255760339950404E-4,239228,823,0.06976093468445618,46184,159,0,1,160,63158,0.02585533850322584,-30033,0,159,0,0.06717044500419815,0,1358,0,622,18,0,1998,736,0.07082895072108805,366589,127361,
0,0.005141576995115502,0,476,-476,476,25288,16151,519238,0.002190264253476783,239228,823,0.06976093468445618,46184,46,783,41,870,63158,0.02585533850322584,-30033,280,-737,0,0.043718120162265416,280,131,0,1032,41,-280,1204,-901,0.06067678321872299,366589,127361,
0,0.005141576995115502,0,476,-476,476,25288,16151,519238,0.002190264253476783,239228,823,0.06976093468445618,46184,46,783,41,870,63158,0.02585533850322584,-30033,280,-737,0,0.043718120162265416,280,131,0,1032,41,-280,1204,-901,0.06067678321872299,366589,127361,
0,0.0026423426358272704,0,322,-322,322,25288,16151,519238,9.691943345790521E-4,239228,823,0.06976093468445618,46184,61,177,6,244,63158,0.02585533850322584,-30033,146,-116,0,0.06860290076798449,146,451,0,454,28,-146,933,-3,0.05879180207520753,366589,127361,
0,0.0,0,322,-322,322,25288,16151,519238,9.691943345790521E-4,239228,823,0.06976093468445618,46184,0,0,0,0,63158,0.02585533850322584,-30033,0,0,0,0.0,0,451,0,454,28,0,933,-3,0.05879180207520753,366589,127361,
0,0.0,0,322,-322,322,25288,16151,519238,9.691943345790521E-4,239228,823,0.06976093468445618,46184,0,0,0,0,63158,0.02585533850322584,-30033,0,0,0,0.0,0,451,0,454,28,0,933,-3,0.05879180207520753,366589,127361,
0,0.0,0,322,-322,322,25288,16151,519238,9.691943345790521E-4,239228,823,0.06976093468445618,46184,0,0,0,0,63158,0.02585533850322584,-30033,0,0,0,0.0,0,451,0,454,28,0,933,-3,0.05879180207520753,366589,127361,
0,0.0,0,322,-322,322,25288,16151,519238,9.691943345790521E-4,239228,823,0.06976093468445618,46184,0,0,0,0,63158,0.02585533850322584,-30033,0,0,0,0.0,0,451,0,454,28,0,933,-3,0.05879180207520753,366589,127361,
0,0.0,0,322,-322,322,25288,16151,519238,9.691943345790521E-4,239228,823,0.06976093468445618,46184,0,0,0,0,63158,0.02585533850322584,-30033,0,0,0,0.0,0,451,0,454,28,0,933,-3,0.05879180207520753,366589,127361,
0,0.0,0,322,-322,322,25288,16151,519238,9.691943345790521E-4,239228,823,0.06976093468445618,46184,0,0,0,0,63158,0.02585533850322584,-30033,0,0,0,0.0,0,451,0,454,28,0,933,-3,0.05879180207520753,366589,127361,
0,0.0,0,322,-322,322,25288,16151,519238,9.691943345790521E-4,239228,823,0.06976093468445618,46184,0,0,0,0,63158,0.02585533850322584,-30033,0,0,0,0.0,0,451,0,454,28,0,933,-3,0.05879180207520753,366589,127361,
0,0.00117011701170117,0,322,-322,322,25288,16151,519238,9.691943345790521E-4,239228,823,0.06976093468445618,46184,102,92,2,196,63158,0.02585533850322584,-30033,65,10,0,0.14004772115868203,65,451,0,454,28,-65,933,-3,0.05879180207520753,366589,127361,
0,0.01506561401649623,0,1347,-1347,1347,25288,16151,519238,0.005929513870987711,239228,823,0.06976093468445618,46184,613,1226,7,1846,63158,0.02585533850322584,-30033,853,-613,0,0.07038086200729153,853,948,0,1861,8,-853,2817,-913,0.03557999400930814,366589,127361,
0,0.01506561401649623,0,1347,-1347,1347,25288,16151,519238,0.005929513870987711,239228,823,0.06976093468445618,46184,613,1226,7,1846,63158,0.02585533850322584,-30033,853,-613,0,0.07038086200729153,853,948,0,1861,8,-853,2817,-913,0.03557999400930814,366589,127361,
28,0.19301124067791062,1,1329,-1301,1358,25288,16151,519238,0.041363279848707066,239228,823,0.06976093468445618,46184,208,1019,26,1253,63158,0.02585533850322584,-30033,521,-811,28,0.07636908359512525,550,830,1,2039,273,-493,3142,-1209,0.07770512787867388,366589,127361,
28,9.946665294712834E-4,1,1329,-1301,1358,25288,16151,519238,0.041363279848707066,239228,823,0.06976093468445618,46184,3,61,0,64,63158,0.02585533850322584,-30033,58,-58,0,0.0023080159638053832,58,830,0,2039,273,-58,3142,-1209,0.07770512787867388,366589,127361,
28,0.004397702285782467,1,1329,-1301,1358,25288,16151,519238,0.041363279848707066,239228,823,0.06976093468445618,46184,67,361,71,499,63158,0.02585533850322584,-30033,258,-294,0,0.12840127273518057,258,830,0,2039,273,-258,3142,-1209,0.07770512787867388,366589,127361,
0,0.001777822928836288,0,2750,-2750,2750,25288,16151,519238,0.011257924171957586,239228,823,0.06976093468445618,46184,2,317,0,319,63158,0.02585533850322584,-30033,105,-315,0,0.013842191262143767,105,1551,0,5364,5,-105,6920,-3813,0.08011110513278975,366589,127361,
0,0.001777822928836288,0,2750,-2750,2750,25288,16151,519238,0.011257924171957586,239228,823,0.06976093468445618,46184,2,317,0,319,63158,0.02585533850322584,-30033,105,-315,0,0.013842191262143767,105,1551,0,5364,5,-105,6920,-3813,0.08011110513278975,366589,127361,
0,0.001777822928836288,0,2750,-2750,2750,25288,16151,519238,0.011257924171957586,239228,823,0.06976093468445618,46184,2,317,0,319,63158,0.02585533850322584,-30033,105,-315,0,0.013842191262143767,105,1551,0,5364,5,-105,6920,-3813,0.08011110513278975,366589,127361,
0,0.001777822928836288,0,2750,-2750,2750,25288,16151,519238,0.011257924171957586,239228,823,0.06976093468445618,46184,2,317,0,319,63158,0.02585533850322584,-30033,105,-315,0,0.013842191262143767,105,1551,0,5364,5,-105,6920,-3813,0.08011110513278975,366589,127361,
0,0.001777822928836288,0,2750,-2750,2750,25288,16151,519238,0.011257924171957586,239228,823,0.06976093468445618,46184,2,317,0,319,63158,0.02585533850322584,-30033,105,-315,0,0.013842191262143767,105,1551,0,5364,5,-105,6920,-3813,0.08011110513278975,366589,127361,
0,0.001777822928836288,0,2750,-2750,2750,25288,16151,519238,0.011257924171957586,239228,823,0.06976093468445618,46184,2,317,0,319,63158,0.02585533850322584,-30033,105,-315,0,0.013842191262143767,105,1551,0,5364,5,-105,6920,-3813,0.08011110513278975,366589,127361,
0,0.001777822928836288,0,2750,-2750,2750,25288,16151,519238,0.011257924171957586,239228,823,0.06976093468445618,46184,2,317,0,319,63158,0.02585533850322584,-30033,105,-315,0,0.013842191262143767,105,1551,0,5364,5,-105,6920,-3813,0.08011110513278975,366589,127361,
0,0.001777822928836288,0,2750,-2750,2750,25288,16151,519238,0.011257924171957586,239228,823,0.06976093468445618,46184,2,317,0,319,63158,0.02585533850322584,-30033,105,-315,0,0.013842191262143767,105,1551,0,5364,5,-105,6920,-3813,0.08011110513278975,366589,127361,
0,0.001777822928836288,0,2750,-2750,2750,25288,16151,519238,0.011257924171957586,239228,823,0.06976093468445618,46184,2,317,0,319,63158,0.02585533850322584,-30033,105,-315,0,0.013842191262143767,105,1551,0,5364,5,-105,6920,-3813,0.08011110513278975,366589,127361,
0,0.001777822928836288,0,2750,-2750,2750,25288,16151,519238,0.011257924171957586,239228,823,0.06976093468445618,46184,2,317,0,319,63158,0.02585533850322584,-30033,105,-315,0,0.013842191262143767,105,1551,0,5364,5,-105,6920,-3813,0.08011110513278975,366589,127361,
0,0.006085977034683344,0,2750,-2750,2750,25288,16151,519238,0.011257924171957586,239228,823,0.06976093468445618,46184,808,368,5,1181,63158,0.02585533850322584,-30033,362,440,0,0.1269925535120152,362,1551,0,5364,5,-362,6920,-3813,0.08011110513278975,366589,127361,
0,0.006085977034683344,0,2750,-2750,2750,25288,16151,519238,0.011257924171957586,239228,823,0.06976093468445618,46184,808,368,5,1181,63158,0.02585533850322584,-30033,362,440,0,0.1269925535120152,362,1551,0,5364,5,-362,6920,-3813,0.08011110513278975,366589,127361,
0,0.006085977034683344,0,2750,-2750,2750,25288,16151,519238,0.011257924171957586,239228,823,0.06976093468445618,46184,808,368,5,1181,63158,0.02585533850322584,-30033,362,440,0,0.1269925535120152,362,1551,0,5364,5,-362,6920,-3813,0.08011110513278975,366589,127361,
0,0.006085977034683344,0,2750,-2750,2750,25288,16151,519238,0.011257924171957586,239228,823,0.06976093468445618,46184,808,368,5,1181,63158,0.02585533850322584,-30033,362,440,0,0.1269925535120152,362,1551,0,5364,5,-362,6920,-3813,0.08011110513278975,366589,127361,
0,0.006085977034683344,0,2750,-2750,2750,25288,16151,519238,0.011257924171957586,239228,823,0.06976093468445618,46184,808,368,5,1181,63158,0.02585533850322584,-30033,362,440,0,0.1269925535120152,362,1551,0,5364,5,-362,6920,-3813,0.08011110513278975,366589,127361,
0,0.01020679566460536,0,2750,-2750,2750,25288,16151,519238,0.011257924171957586,239228,823,0.06976093468445618,46184,616,1242,0,1858,63158,0.02585533850322584,-30033,614,-626,0,0.11111926815259295,614,1551,0,5364,5,-614,6920,-3813,0.08011110513278975,366589,127361,
0,0.01020679566460536,0,2750,-2750,2750,25288,16151,519238,0.011257924171957586,239228,823,0.06976093468445618,46184,616,1242,0,1858,63158,0.02585533850322584,-30033,614,-626,0,0.11111926815259295,614,1551,0,5364,5,-614,6920,-3813,0.08011110513278975,366589,127361,
0,0.01020679566460536,0,2750,-2750,2750,25288,16151,519238,0.011257924171957586,239228,823,0.06976093468445618,46184,616,1242,0,1858,63158,0.02585533850322584,-30033,614,-626,0,0.11111926815259295,614,1551,0,5364,5,-614,6920,-3813,0.08011110513278975,366589,127361,
0,0.01020679566460536,0,2750,-2750,2750,25288,16151,519238,0.011257924171957586,239228,823,0.06976093468445618,46184,616,1242,0,1858,63158,0.02585533850322584,-30033,614,-626,0,0.11111926815259295,614,1551,0,5364,5,-614,6920,-3813,0.08011110513278975,366589,127361,
0,0.01020679566460536,0,2750,-2750,2750,25288,16151,519238,0.011257924171957586,239228,823,0.06976093468445618,46184,616,1242,0,1858,63158,0.02585533850322584,-30033,614,-626,0,0.11111926815259295,614,1551,0,5364,5,-614,6920,-3813,0.08011110513278975,366589,127361,
0,0.01020679566460536,0,2750,-2750,2750,25288,16151,519238,0.011257924171957586,239228,823,0.06976093468445618,46184,616,1242,0,1858,63158,0.02585533850322584,-30033,614,-626,0,0.11111926815259295,614,1551,0,5364,5,-614,6920,-3813,0.08011110513278975,366589,127361,
0,0.02696110105970535,0,2750,-2750,2750,25288,16151,519238,0.011257924171957586,239228,823,0.06976093468445618,46184,125,3437,0,3562,63158,0.02585533850322584,-30033,1669,-3312,0,0.06849040760440711,1669,1551,0,5364,5,-1669,6920,-3813,0.08011110513278975,366589,127361,
0,0.02696110105970535,0,2750,-2750,2750,25288,16151,519238,0.011257924171957586,239228,823,0.06976093468445618,46184,125,3437,0,3562,63158,0.02585533850322584,-30033,1669,-3312,0,0.06849040760440711,1669,1551,0,5364,5,-1669,6920,-3813,0.08011110513278975,366589,127361,
0,0.02696110105970535,0,2750,-2750,2750,25288,16151,519238,0.011257924171957586,239228,823,0.06976093468445618,46184,125,3437,0,3562,63158,0.02585533850322584,-30033,1669,-3312,0,0.06849040760440711,1669,1551,0,5364,5,-1669,6920,-3813,0.08011110513278975,366589,127361,
0,0.02696110105970535,0,2750,-2750,2750,25288,16151,519238,0.011257924171957586,239228,823,0.06976093468445618,46184,125,3437,0,3562,63158,0.02585533850322584,-30033,1669,-3312,0,0.06849040760440711,1669,1551,0,5364,5,-1669,6920,-3813,0.08011110513278975,366589,127361,
0,0.02696110105970535,0,2750,-2750,2750,25288,16151,519238,0.011257924171957586,239228,823,0.06976093468445618,46184,125,3437,0,3562,63158,0.02585533850322584,-30033,1669,-3312,0,0.06849040760440711,1669,1551,0,5364,5,-1669,6920,-3813,0.08011110513278975,366589,127361,
0,0.02696110105970535,0,2750,-2750,2750,25288,16151,519238,0.011257924171957586,239228,823,0.06976093468445618,46184,125,3437,0,3562,63158,0.02585533850322584,-30033,1669,-3312,0,0.06849040760440711,1669,1551,0,5364,5,-1669,6920,-3813,0.08011110513278975,366589,127361,
0,0.02696110105970535,0,2750,-2750,2750,25288,16151,519238,0.011257924171957586,239228,823,0.06976093468445618,46184,125,3437,0,3562,63158,0.02585533850322584,-30033,1669,-3312,0,0.06849040760440711,1669,1551,0,5364,5,-1669,6920,-3813,0.08011110513278975,366589,127361,
0,0.02696110105970535,0,2750,-2750,2750,25288,16151,519238,0.011257924171957586,239228,823,0.06976093468445618,46184,125,3437,0,3562,63158,0.02585533850322584,-30033,1669,-3312,0,0.06849040760440711,1669,1551,0,5364,5,-1669,6920,-3813,0.08011110513278975,366589,127361,
0,0.02696110105970535,0,2750,-2750,2750,25288,16151,519238,0.011257924171957586,239228,823,0.06976093468445618,46184,125,3437,0,3562,63158,0.02585533850322584,-30033,1669,-3312,0,0.06849040760440711,1669,1551,0,5364,5,-1669,6920,-3813,0.08011110513278975,366589,127361,
0,0.02696110105970535,0,2750,-2750,2750,25288,16151,519238,0.011257924171957586,239228,823,0.06976093468445618,46184,125,3437,0,3562,63158,0.02585533850322584,-30033,1669,-3312,0,0.06849040760440711,1669,1551,0,5364,5,-1669,6920,-3813,0.08011110513278975,366589,127361,
0,0.02696110105970535,0,2750,-2750,2750,25288,16151,519238,0.011257924171957586,239228,823,0.06976093468445618,46184,125,3437,0,3562,63158,0.02585533850322584,-30033,1669,-3312,0,0.06849040760440711,1669,1551,0,5364,5,-1669,6920,-3813,0.08011110513278975,366589,127361,
0,0.02696110105970535,0,2750,-2750,2750,25288,16151,519238,0.011257924171957586,239228,823,0.06976093468445618,46184,125,3437,0,3562,63158,0.02585533850322584,-30033,1669,-3312,0,0.06849040760440711,1669,1551,0,5364,5,-1669,6920,-3813,0.08011110513278975,366589,127361,
0,0.02696110105970535,0,2750,-2750,2750,25288,16151,519238,0.011257924171957586,239228,823,0.06976093468445618,46184,125,3437,0,3562,63158,0.02585533850322584,-30033,1669,-3312,0,0.06849040760440711,1669,1551,0,5364,5,-1669,6920,-3813,0.08011110513278975,366589,127361,
0,0.02696110105970535,0,2750,-2750,2750,25288,16151,519238,0.011257924171957586,239228,823,0.06976093468445618,46184,125,3437,0,3562,63158,0.02585533850322584,-30033,1669,-3312,0,0.06849040760440711,1669,1551,0,5364,5,-1669,6920,-3813,0.08011110513278975,366589,127361,
0,0.02696110105970535,0,2750,-2750,2750,25288,16151,519238,0.011257924171957586,239228,823,0.06976093468445618,46184,125,3437,0,3562,63158,0.02585533850322584,-30033,1669,-3312,0,0.06849040760440711,1669,1551,0,5364,5,-1669,6920,-3813,0.08011110513278975,366589,127361,
0,0.02696110105970535,0,2750,-2750,2750,25288,16151,519238,0.011257924171957586,239228,823,0.06976093468445618,46184,125,3437,0,3562,63158,0.02585533850322584,-30033,1669,-3312,0,0.06849040760440711,1669,1551,0,5364,5,-1669,6920,-3813,0.08011110513278975,366589,127361,
0,0.02696110105970535,0,2750,-2750,2750,25288,16151,519238,0.011257924171957586,239228,823,0.06976093468445618,46184,125,3437,0,3562,63158,0.02585533850322584,-30033,1669,-3312,0,0.06849040760440711,1669,1551,0,5364,5,-1669,6920,-3813,0.08011110513278975,366589,127361,
0,0.02696110105970535,0,2750,-2750,2750,25288,16151,519238,0.011257924171957586,239228,823,0.06976093468445618,46184,125,3437,0,3562,63158,0.02585533850322584,-30033,1669,-3312,0,0.06849040760440711,1669,1551,0,5364,5,-1669,6920,-3813,0.08011110513278975,366589,127361,
0,0.02696110105970535,0,2750,-2750,2750,25288,16151,519238,0.011257924171957586,239228,823,0.06976093468445618,46184,125,3437,0,3562,63158,0.02585533850322584,-30033,1669,-3312,0,0.06849040760440711,1669,1551,0,5364,5,-1669,6920,-3813,0.08011110513278975,366589,127361,
99,9.679136621013406E-4,34,400,-301,533,25288,16151,519238,0.024511777972138223,239228,823,0.06976093468445618,46184,30,94,0,124,63158,0.02585533850322584,-30033,60,-64,0,0.0761914275854442,60,3968,0,1649,166,-60,5783,2319,0.08290951488392151,366589,127361,
99,0.001198485114814874,34,400,-301,533,25288,16151,519238,0.024511777972138223,239228,823,0.06976093468445618,46184,120,124,6,250,63158,0.02585533850322584,-30033,75,-4,0,0.06366234214489978,75,3968,0,1649,166,-75,5783,2319,0.08290951488392151,366589,127361,
99,0.0,34,400,-301,533,25288,16151,519238,0.024511777972138223,239228,823,0.06976093468445618,46184,104,0,0,104,63158,0.02585533850322584,-30033,0,104,0,0.1205098493626883,0,3968,0,1649,166,0,5783,2319,0.08290951488392151,366589,127361,
99,0.0,34,400,-301,533,25288,16151,519238,0.024511777972138223,239228,823,0.06976093468445618,46184,104,0,0,104,63158,0.02585533850322584,-30033,0,104,0,0.1205098493626883,0,3968,0,1649,166,0,5783,2319,0.08290951488392151,366589,127361,
99,0.011218228974456854,34,400,-301,533,25288,16151,519238,0.024511777972138223,239228,823,0.06976093468445618,46184,1622,316,80,2018,63158,0.02585533850322584,-30033,4,1306,10,0.08149615984156447,17,3968,3,1649,166,6,5783,2319,0.08290951488392151,366589,127361,
99,0.011218228974456854,34,400,-301,533,25288,16151,519238,0.024511777972138223,239228,823,0.06976093468445618,46184,1622,316,80,2018,63158,0.02585533850322584,-30033,4,1306,10,0.08149615984156447,17,3968,3,1649,166,6,5783,2319,0.08290951488392151,366589,127361,
99,0.011218228974456854,34,400,-301,533,25288,16151,519238,0.024511777972138223,239228,823,0.06976093468445618,46184,1622,316,80,2018,63158,0.02585533850322584,-30033,4,1306,10,0.08149615984156447,17,3968,3,1649,166,6,5783,2319,0.08290951488392151,366589,127361,
99,0.011218228974456854,34,400,-301,533,25288,16151,519238,0.024511777972138223,239228,823,0.06976093468445618,46184,1622,316,80,2018,63158,0.02585533850322584,-30033,4,1306,10,0.08149615984156447,17,3968,3,1649,166,6,5783,2319,0.08290951488392151,366589,127361,
99,0.011218228974456854,34,400,-301,533,25288,16151,519238,0.024511777972138223,239228,823,0.06976093468445618,46184,1622,316,80,2018,63158,0.02585533850322584,-30033,4,1306,10,0.08149615984156447,17,3968,3,1649,166,6,5783,2319,0.08290951488392151,366589,127361,
99,0.011218228974456854,34,400,-301,533,25288,16151,519238,0.024511777972138223,239228,823,0.06976093468445618,46184,1622,316,80,2018,63158,0.02585533850322584,-30033,4,1306,10,0.08149615984156447,17,3968,3,1649,166,6,5783,2319,0.08290951488392151,366589,127361,
99,0.011218228974456854,34,400,-301,533,25288,16151,519238,0.024511777972138223,239228,823,0.06976093468445618,46184,1622,316,80,2018,63158,0.02585533850322584,-30033,4,1306,10,0.08149615984156447,17,3968,3,1649,166,6,5783,2319,0.08290951488392151,366589,127361,
99,0.011218228974456854,34,400,-301,533,25288,16151,519238,0.024511777972138223,239228,823,0.06976093468445618,46184,1622,316,80,2018,63158,0.02585533850322584,-30033,4,1306,10,0.08149615984156447,17,3968,3,1649,166,6,5783,2319,0.08290951488392151,366589,127361,
99,0.011218228974456854,34,400,-301,533,25288,16151,519238,0.024511777972138223,239228,823,0.06976093468445618,46184,1622,316,80,2018,63158,0.02585533850322584,-30033,4,1306,10,0.08149615984156447,17,3968,3,1649,166,6,5783,2319,0.08290951488392151,366589,127361,
99,0.011218228974456854,34,400,-301,533,25288,16151,519238,0.024511777972138223,239228,823,0.06976093468445618,46184,1622,316,80,2018,63158,0.02585533850322584,-30033,4,1306,10,0.08149615984156447,17,3968,3,1649,166,6,5783,2319,0.08290951488392151,366589,127361,
99,0.011218228974456854,34,400,-301,533,25288,16151,519238,0.024511777972138223,239228,823,0.06976093468445618,46184,1622,316,80,2018,63158,0.02585533850322584,-30033,4,1306,10,0.08149615984156447,17,3968,3,1649,166,6,5783,2319,0.08290951488392151,366589,127361,
99,0.011218228974456854,34,400,-301,533,25288,16151,519238,0.024511777972138223,239228,823,0.06976093468445618,46184,1622,316,80,2018,63158,0.02585533850322584,-30033,4,1306,10,0.08149615984156447,17,3968,3,1649,166,6,5783,2319,0.08290951488392151,366589,127361,
99,0.0036263578960762173,34,400,-301,533,25288,16151,519238,0.024511777972138223,239228,823,0.06976093468445618,46184,228,228,0,456,63158,0.02585533850322584,-30033,228,0,0,0.005645187809967928,228,3968,0,1649,166,-228,5783,2319,0.08290951488392151,366589,127361,
99,0.0036263578960762173,34,400,-301,533,25288,16151,519238,0.024511777972138223,239228,823,0.06976093468445618,46184,228,228,0,456,63158,0.02585533850322584,-30033,228,0,0,0.005645187809967928,228,3968,0,1649,166,-228,5783,2319,0.08290951488392151,366589,127361,
99,0.16818925912235308,34,400,-301,533,25288,16151,519238,0.024511777972138223,239228,823,0.06976093468445618,46184,1055,438,39,1532,63158,0.02585533850322584,-30033,16,617,5,0.14946122901579445,26,3968,5,1649,166,-11,5783,2319,0.08290951488392151,366589,127361,
99,0.16818925912235308,34,400,-301,533,25288,16151,519238,0.024511777972138223,239228,823,0.06976093468445618,46184,1055,438,39,1532,63158,0.02585533850322584,-30033,16,617,5,0.14946122901579445,26,3968,5,1649,166,-11,5783,2319,0.08290951488392151,366589,127361,
99,0.16818925912235308,34,400,-301,533,25288,16151,519238,0.024511777972138223,239228,823,0.06976093468445618,46184,1055,438,39,1532,63158,0.02585533850322584,-30033,16,617,5,0.14946122901579445,26,3968,5,1649,166,-11,5783,2319,0.08290951488392151,366589,127361,
99,0.16818925912235308,34,400,-301,533,25288,16151,519238,0.024511777972138223,239228,823,0.06976093468445618,46184,1055,438,39,1532,63158,0.02585533850322584,-30033,16,617,5,0.14946122901579445,26,3968,5,1649,166,-11,5783,2319,0.08290951488392151,366589,127361,
99,0.16818925912235308,34,400,-301,533,25288,16151,519238,0.024511777972138223,239228,823,0.06976093468445618,46184,1055,438,39,1532,63158,0.02585533850322584,-30033,16,617,5,0.14946122901579445,26,3968,5,1649,166,-11,5783,2319,0.08290951488392151,366589,127361,
99,0.0,34,400,-301,533,25288,16151,519238,0.024511777972138223,239228,823,0.06976093468445618,46184,29,0,0,29,63158,0.02585533850322584,-30033,0,29,0,0.023848684210526317,0,3968,0,1649,166,0,5783,2319,0.08290951488392151,366589,127361,
99,0.0,34,400,-301,533,25288,16151,519238,0.024511777972138223,239228,823,0.06976093468445618,46184,29,0,0,29,63158,0.02585533850322584,-30033,0,29,0,0.023848684210526317,0,3968,0,1649,166,0,5783,2319,0.08290951488392151,366589,127361,
99,0.1571753986332574,34,400,-301,533,25288,16151,519238,0.024511777972138223,239228,823,0.06976093468445618,46184,199,23,26,248,63158,0.02585533850322584,-30033,16,176,27,0.08052255895970234,69,3968,26,1649,166,11,5783,2319,0.08290951488392151,366589,127361,
99,0.1571753986332574,34,400,-301,533,25288,16151,519238,0.024511777972138223,239228,823,0.06976093468445618,46184,199,23,26,248,63158,0.02585533850322584,-30033,16,176,27,0.08052255895970234,69,3968,26,1649,166,11,5783,2319,0.08290951488392151,366589,127361,
99,0.1571753986332574,34,400,-301,533,25288,16151,519238,0.024511777972138223,239228,823,0.06976093468445618,46184,199,23,26,248,63158,0.02585533850322584,-30033,16,176,27,0.08052255895970234,69,3968,26,1649,166,11,5783,2319,0.08290951488392151,366589,127361,
99,0.1571753986332574,34,400,-301,533,25288,16151,519238,0.024511777972138223,239228,823,0.06976093468445618,46184,199,23,26,248,63158,0.02585533850322584,-30033,16,176,27,0.08052255895970234,69,3968,26,1649,166,11,5783,2319,0.08290951488392151,366589,127361,
99,0.1571753986332574,34,400,-301,533,25288,16151,519238,0.024511777972138223,239228,823,0.06976093468445618,46184,199,23,26,248,63158,0.02585533850322584,-30033,16,176,27,0.08052255895970234,69,3968,26,1649,166,11,5783,2319,0.08290951488392151,366589,127361,
99,0.1571753986332574,34,400,-301,533,25288,16151,519238,0.024511777972138223,239228,823,0.06976093468445618,46184,199,23,26,248,63158,0.02585533850322584,-30033,16,176,27,0.08052255895970234,69,3968,26,1649,166,11,5783,2319,0.08290951488392151,366589,127361,
99,0.013729977116704805,34,400,-301,533,25288,16151,519238,0.024511777972138223,239228,823,0.06976093468445618,46184,51,25,2,78,63158,0.02585533850322584,-30033,1,26,5,0.009666995881170367,6,3968,0,1649,166,4,5783,2319,0.08290951488392151,366589,127361,
99,0.013729977116704805,34,400,-301,533,25288,16151,519238,0.024511777972138223,239228,823,0.06976093468445618,46184,51,25,2,78,63158,0.02585533850322584,-30033,1,26,5,0.009666995881170367,6,3968,0,1649,166,4,5783,2319,0.08290951488392151,366589,127361,
99,0.013729977116704805,34,400,-301,533,25288,16151,519238,0.024511777972138223,239228,823,0.06976093468445618,46184,51,25,2,78,63158,0.02585533850322584,-30033,1,26,5,0.009666995881170367,6,3968,0,1649,166,4,5783,2319,0.08290951488392151,366589,127361,
99,0.013729977116704805,34,400,-301,533,25288,16151,519238,0.024511777972138223,239228,823,0.06976093468445618,46184,51,25,2,78,63158,0.02585533850322584,-30033,1,26,5,0.009666995881170367,6,3968,0,1649,166,4,5783,2319,0.08290951488392151,366589,127361,
99,0.0,34,400,-301,533,25288,16151,519238,0.024511777972138223,239228,823,0.06976093468445618,46184,45,125,0,170,63158,0.02585533850322584,-30033,0,-80,0,0.10792737510368505,0,3968,0,1649,166,0,5783,2319,0.08290951488392151,366589,127361,
99,0.0,34,400,-301,533,25288,16151,519238,0.024511777972138223,239228,823,0.06976093468445618,46184,45,125,0,170,63158,0.02585533850322584,-30033,0,-80,0,0.10792737510368505,0,3968,0,1649,166,0,5783,2319,0.08290951488392151,366589,127361,
1,0.0,0,1,0,2,25288,16151,519238,0.002285714285714286,239228,823,0.06976093468445618,46184,71,114,1,186,63158,0.02585533850322584,-30033,0,-43,0,0.5078381849578133,0,378,0,697,5,0,1080,-319,0.20786902433770157,366589,127361,
1,0.0,0,1,0,2,25288,16151,519238,0.002285714285714286,239228,823,0.06976093468445618,46184,168,172,4,344,63158,0.02585533850322584,-30033,0,-4,0,0.24693547753649914,0,378,0,697,5,0,1080,-319,0.20786902433770157,366589,127361,
1,0.0,0,1,0,2,25288,16151,519238,0.002285714285714286,239228,823,0.06976093468445618,46184,126,126,0,252,63158,0.02585533850322584,-30033,0,0,0,0.15077746152224328,0,378,0,697,5,0,1080,-319,0.20786902433770157,366589,127361,
1,0.011428571428571429,0,1,0,2,25288,16151,519238,0.002285714285714286,239228,823,0.06976093468445618,46184,13,266,0,279,63158,0.02585533850322584,-30033,1,-253,1,0.10131536519331975,2,378,0,697,5,0,1080,-319,0.20786902433770157,366589,127361,
1,0.011428571428571429,0,1,0,2,25288,16151,519238,0.002285714285714286,239228,823,0.06976093468445618,46184,13,266,0,279,63158,0.02585533850322584,-30033,1,-253,1,0.10131536519331975,2,378,0,697,5,0,1080,-319,0.20786902433770157,366589,127361,
1,0.011428571428571429,0,1,0,2,25288,16151,519238,0.002285714285714286,239228,823,0.06976093468445618,46184,13,266,0,279,63158,0.02585533850322584,-30033,1,-253,1,0.10131536519331975,2,378,0,697,5,0,1080,-319,0.20786902433770157,366589,127361,
1,0.011428571428571429,0,1,0,2,25288,16151,519238,0.002285714285714286,239228,823,0.06976093468445618,46184,13,266,0,279,63158,0.02585533850322584,-30033,1,-253,1,0.10131536519331975,2,378,0,697,5,0,1080,-319,0.20786902433770157,366589,127361,
1,0.011428571428571429,0,1,0,2,25288,16151,519238,0.002285714285714286,239228,823,0.06976093468445618,46184,13,266,0,279,63158,0.02585533850322584,-30033,1,-253,1,0.10131536519331975,2,378,0,697,5,0,1080,-319,0.20786902433770157,366589,127361,
1,0.011428571428571429,0,1,0,2,25288,16151,519238,0.002285714285714286,239228,823,0.06976093468445618,46184,13,266,0,279,63158,0.02585533850322584,-30033,1,-253,1,0.10131536519331975,2,378,0,697,5,0,1080,-319,0.20786902433770157,366589,127361,
1,0.011428571428571429,0,1,0,2,25288,16151,519238,0.002285714285714286,239228,823,0.06976093468445618,46184,13,266,0,279,63158,0.02585533850322584,-30033,1,-253,1,0.10131536519331975,2,378,0,697,5,0,1080,-319,0.20786902433770157,366589,127361,
1,0.011428571428571429,0,1,0,2,25288,16151,519238,0.002285714285714286,239228,823,0.06976093468445618,46184,13,266,0,279,63158,0.02585533850322584,-30033,1,-253,1,0.10131536519331975,2,378,0,697,5,0,1080,-319,0.20786902433770157,366589,127361,
1,0.011428571428571429,0,1,0,2,25288,16151,519238,0.002285714285714286,239228,823,0.06976093468445618,46184,13,266,0,279,63158,0.02585533850322584,-30033,1,-253,1,0.10131536519331975,2,378,0,697,5,0,1080,-319,0.20786902433770157,366589,127361,
6,0.0081799591002045,0,6,0,12,25288,16151,519238,0.01517441688153878,239228,823,0.06976093468445618,46184,151,3,0,154,63158,0.02585533850322584,-30033,2,148,2,0.21483668837995137,4,1053,0,747,29,0,1829,306,0.17687846690960748,366589,127361,
6,0.17391304347826086,0,6,0,12,25288,16151,519238,0.01517441688153878,239228,823,0.06976093468445618,46184,184,4,0,188,63158,0.02585533850322584,-30033,4,180,4,0.1450210378681627,8,1053,0,747,29,0,1829,306,0.17687846690960748,366589,127361,
6,0.17391304347826086,0,6,0,12,25288,16151,519238,0.01517441688153878,239228,823,0.06976093468445618,46184,184,4,0,188,63158,0.02585533850322584,-30033,4,180,4,0.1450210378681627,8,1053,0,747,29,0,1829,306,0.17687846690960748,366589,127361,
6,0.0,0,6,0,12,25288,16151,519238,0.01517441688153878,239228,823,0.06976093468445618,46184,58,55,12,125,63158,0.02585533850322584,-30033,0,3,0,0.11032656663724624,0,1053,0,747,29,0,1829,306,0.17687846690960748,366589,127361,
6,0.0,0,6,0,12,25288,16151,519238,0.01517441688153878,239228,823,0.06976093468445618,46184,58,55,12,125,63158,0.02585533850322584,-30033,0,3,0,0.11032656663724624,0,1053,0,747,29,0,1829,306,0.17687846690960748,366589,127361,
6,0.0,0,6,0,12,25288,16151,519238,0.01517441688153878,239228,823,0.06976093468445618,46184,58,55,12,125,63158,0.02585533850322584,-30033,0,3,0,0.11032656663724624,0,1053,0,747,29,0,1829,306,0.17687846690960748,366589,127361,
6,0.0,0,6,0,12,25288,16151,519238,0.01517441688153878,239228,823,0.06976093468445618,46184,58,55,12,125,63158,0.02585533850322584,-30033,0,3,0,0.11032656663724624,0,1053,0,747,29,0,1829,306,0.17687846690960748,366589,127361,
6,0.0,0,6,0,12,25288,16151,519238,0.01517441688153878,239228,823,0.06976093468445618,46184,58,55,12,125,63158,0.02585533850322584,-30033,0,3,0,0.11032656663724624,0,1053,0,747,29,0,1829,306,0.17687846690960748,366589,127361,
6,0.0,0,6,0,12,25288,16151,519238,0.01517441688153878,239228,823,0.06976093468445618,46184,58,55,12,125,63158,0.02585533850322584,-30033,0,3,0,0.11032656663724624,0,1053,0,747,29,0,1829,306,0.17687846690960748,366589,127361,
6,0.0,0,6,0,12,25288,16151,519238,0.01517441688153878,239228,823,0.06976093468445618,46184,58,55,12,125,63158,0.02585533850322584,-30033,0,3,0,0.11032656663724624,0,1053,0,747,29,0,1829,306,0.17687846690960748,366589,127361,
6,0.0,0,6,0,12,25288,16151,519238,0.01517441688153878,239228,823,0.06976093468445618,46184,58,55,12,125,63158,0.02585533850322584,-30033,0,3,0,0.11032656663724624,0,1053,0,747,29,0,1829,306,0.17687846690960748,366589,127361,
6,0.0,0,6,0,12,25288,16151,519238,0.01517441688153878,239228,823,0.06976093468445618,46184,58,55,12,125,63158,0.02585533850322584,-30033,0,3,0,0.11032656663724624,0,1053,0,747,29,0,1829,306,0.17687846690960748,366589,127361,
6,0.0,0,6,0,12,25288,16151,519238,0.01517441688153878,239228,823,0.06976093468445618,46184,58,55,12,125,63158,0.02585533850322584,-30033,0,3,0,0.11032656663724624,0,1053,0,747,29,0,1829,306,0.17687846690960748,366589,127361,
6,0.0,0,6,0,12,25288,16151,519238,0.01517441688153878,239228,823,0.06976093468445618,46184,58,55,12,125,63158,0.02585533850322584,-30033,0,3,0,0.11032656663724624,0,1053,0,747,29,0,1829,306,0.17687846690960748,366589,127361,
6,0.0,0,6,0,12,25288,16151,519238,0.01517441688153878,239228,823,0.06976093468445618,46184,58,55,12,125,63158,0.02585533850322584,-30033,0,3,0,0.11032656663724624,0,1053,0,747,29,0,1829,306,0.17687846690960748,366589,127361,
6,0.0,0,6,0,12,25288,16151,519238,0.01517441688153878,239228,823,0.06976093468445618,46184,58,55,12,125,63158,0.02585533850322584,-30033,0,3,0,0.11032656663724624,0,1053,0,747,29,0,1829,306,0.17687846690960748,366589,127361,
6,0.0,0,6,0,12,25288,16151,519238,0.01517441688153878,239228,823,0.06976093468445618,46184,58,55,12,125,63158,0.02585533850322584,-30033,0,3,0,0.11032656663724624,0,1053,0,747,29,0,1829,306,0.17687846690960748,366589,127361,
6,0.0,0,6,0,12,25288,16151,519238,0.01517441688153878,239228,823,0.06976093468445618,46184,0,0,0,0,63158,0.02585533850322584,-30033,0,0,0,0.0,0,1053,0,747,29,0,1829,306,0.17687846690960748,366589,127361,
6,0.0,0,6,0,12,25288,16151,519238,0.01517441688153878,239228,823,0.06976093468445618,46184,14,32,0,46,63158,0.02585533850322584,-30033,0,-18,0,0.054496491940573356,0,1053,0,747,29,0,1829,306,0.17687846690960748,366589,127361,
6,0.0,0,6,0,12,25288,16151,519238,0.01517441688153878,239228,823,0.06976093468445618,46184,14,32,0,46,63158,0.02585533850322584,-30033,0,-18,0,0.054496491940573356,0,1053,0,747,29,0,1829,306,0.17687846690960748,366589,127361,
6,0.0,0,6,0,12,25288,16151,519238,0.01517441688153878,239228,823,0.06976093468445618,46184,14,32,0,46,63158,0.02585533850322584,-30033,0,-18,0,0.054496491940573356,0,1053,0,747,29,0,1829,306,0.17687846690960748,366589,127361,
6,0.0,0,6,0,12,25288,16151,519238,0.01517441688153878,239228,823,0.06976093468445618,46184,14,32,0,46,63158,0.02585533850322584,-30033,0,-18,0,0.054496491940573356,0,1053,0,747,29,0,1829,306,0.17687846690960748,366589,127361,
6,0.0,0,6,0,12,25288,16151,519238,0.01517441688153878,239228,823,0.06976093468445618,46184,14,32,0,46,63158,0.02585533850322584,-30033,0,-18,0,0.054496491940573356,0,1053,0,747,29,0,1829,306,0.17687846690960748,366589,127361,
6,0.0,0,6,0,12,25288,16151,519238,0.01517441688153878,239228,823,0.06976093468445618,46184,14,32,0,46,63158,0.02585533850322584,-30033,0,-18,0,0.054496491940573356,0,1053,0,747,29,0,1829,306,0.17687846690960748,366589,127361,
6,0.0,0,6,0,12,25288,16151,519238,0.01517441688153878,239228,823,0.06976093468445618,46184,14,32,0,46,63158,0.02585533850322584,-30033,0,-18,0,0.054496491940573356,0,1053,0,747,29,0,1829,306,0.17687846690960748,366589,127361,
6,0.0,0,6,0,12,25288,16151,519238,0.01517441688153878,239228,823,0.06976093468445618,46184,14,32,0,46,63158,0.02585533850322584,-30033,0,-18,0,0.054496491940573356,0,1053,0,747,29,0,1829,306,0.17687846690960748,366589,127361,
6,0.0,0,6,0,12,25288,16151,519238,0.01517441688153878,239228,823,0.06976093468445618,46184,14,32,0,46,63158,0.02585533850322584,-30033,0,-18,0,0.054496491940573356,0,1053,0,747,29,0,1829,306,0.17687846690960748,366589,127361,
6,0.0,0,6,0,12,25288,16151,519238,0.01517441688153878,239228,823,0.06976093468445618,46184,242,0,0,242,63158,0.02585533850322584,-30033,0,242,0,0.24897119341563786,0,1053,0,747,29,0,1829,306,0.17687846690960748,366589,127361,
6,0.0,0,6,0,12,25288,16151,519238,0.01517441688153878,239228,823,0.06976093468445618,46184,242,0,0,242,63158,0.02585533850322584,-30033,0,242,0,0.24897119341563786,0,1053,0,747,29,0,1829,306,0.17687846690960748,366589,127361,
49,0.0,0,268,-219,317,25288,16151,519238,9.229331421376118E-4,239228,823,0.06976093468445618,46184,10,0,0,10,63158,0.02585533850322584,-30033,0,10,0,0.021929824561403508,0,16591,0,945,181,0,17717,15646,0.021824602882925686,366589,127361,
49,0.0,0,268,-219,317,25288,16151,519238,9.229331421376118E-4,239228,823,0.06976093468445618,46184,10,0,0,10,63158,0.02585533850322584,-30033,0,10,0,0.021929824561403508,0,16591,0,945,181,0,17717,15646,0.021824602882925686,366589,127361,
49,0.0042948728650850625,0,268,-219,317,25288,16151,519238,9.229331421376118E-4,239228,823,0.06976093468445618,46184,620,120,25,765,63158,0.02585533850322584,-30033,1,500,7,0.09728177828259794,8,16591,0,945,181,6,17717,15646,0.021824602882925686,366589,127361,
49,0.0042948728650850625,0,268,-219,317,25288,16151,519238,9.229331421376118E-4,239228,823,0.06976093468445618,46184,620,120,25,765,63158,0.02585533850322584,-30033,1,500,7,0.09728177828259794,8,16591,0,945,181,6,17717,15646,0.021824602882925686,366589,127361,
49,0.0,0,268,-219,317,25288,16151,519238,9.229331421376118E-4,239228,823,0.06976093468445618,46184,142,0,0,142,63158,0.02585533850322584,-30033,0,142,0,0.0027144823367487385,0,16591,0,945,181,0,17717,15646,0.021824602882925686,366589,127361,
49,0.0,0,268,-219,317,25288,16151,519238,9.229331421376118E-4,239228,823,0.06976093468445618,46184,105,0,0,105,63158,0.02585533850322584,-30033,0,105,0,0.001964342506501038,0,16591,0,945,181,0,17717,15646,0.021824602882925686,366589,127361,
49,0.0,0,268,-219,317,25288,16151,519238,9.229331421376118E-4,239228,823,0.06976093468445618,46184,105,0,0,105,63158,0.02585533850322584,-30033,0,105,0,0.001964342506501038,0,16591,0,945,181,0,17717,15646,0.021824602882925686,366589,127361,
49,0.0,0,268,-219,317,25288,16151,519238,9.229331421376118E-4,239228,823,0.06976093468445618,46184,105,0,0,105,63158,0.02585533850322584,-30033,0,105,0,0.0019584802193497847,0,16591,0,945,181,0,17717,15646,0.021824602882925686,366589,127361,
49,0.0,0,268,-219,317,25288,16151,519238,9.229331421376118E-4,239228,823,0.06976093468445618,46184,105,0,0,105,63158,0.02585533850322584,-30033,0,105,0,0.0019584802193497847,0,16591,0,945,181,0,17717,15646,0.021824602882925686,366589,127361,
49,0.0,0,268,-219,317,25288,16151,519238,9.229331421376118E-4,239228,823,0.06976093468445618,46184,216,0,0,216,63158,0.02585533850322584,-30033,0,216,0,0.0039894353840755035,0,16591,0,945,181,0,17717,15646,0.021824602882925686,366589,127361,
49,0.0,0,268,-219,317,25288,16151,519238,9.229331421376118E-4,239228,823,0.06976093468445618,46184,216,0,0,216,63158,0.02585533850322584,-30033,0,216,0,0.0039894353840755035,0,16591,0,945,181,0,17717,15646,0.021824602882925686,366589,127361,
49,0.0,0,268,-219,317,25288,16151,519238,9.229331421376118E-4,239228,823,0.06976093468445618,46184,319,0,0,319,63158,0.02585533850322584,-30033,0,319,0,0.005338822781208683,0,16591,0,945,181,0,17717,15646,0.021824602882925686,366589,127361,
49,0.06872271778326058,0,268,-219,317,25288,16151,519238,9.229331421376118E-4,239228,823,0.06976093468445618,46184,1,261,0,262,63158,0.02585533850322584,-30033,261,-260,1,0.06872271778326058,262,16591,0,945,181,-260,17717,15646,0.021824602882925686,366589,127361,
49,0.0,0,268,-219,317,25288,16151,519238,9.229331421376118E-4,239228,823,0.06976093468445618,46184,387,0,0,387,63158,0.02585533850322584,-30033,0,387,0,0.00622026488363122,0,16591,0,945,181,0,17717,15646,0.021824602882925686,366589,127361,
49,0.0,0,268,-219,317,25288,16151,519238,9.229331421376118E-4,239228,823,0.06976093468445618,46184,387,0,0,387,63158,0.02585533850322584,-30033,0,387,0,0.00622026488363122,0,16591,0,945,181,0,17717,15646,0.021824602882925686,366589,127361,
49,0.0,0,268,-219,317,25288,16151,519238,9.229331421376118E-4,239228,823,0.06976093468445618,46184,387,0,0,387,63158,0.02585533850322584,-30033,0,387,0,0.00622026488363122,0,16591,0,945,181,0,17717,15646,0.021824602882925686,366589,127361,
49,0.0,0,268,-219,317,25288,16151,519238,9.229331421376118E-4,239228,823,0.06976093468445618,46184,387,0,0,387,63158,0.02585533850322584,-30033,0,387,0,0.00622026488363122,0,16591,0,945,181,0,17717,15646,0.021824602882925686,366589,127361,
49,0.0,0,268,-219,317,25288,16151,519238,9.229331421376118E-4,239228,823,0.06976093468445618,46184,387,0,0,387,63158,0.02585533850322584,-30033,0,387,0,0.00622026488363122,0,16591,0,945,181,0,17717,15646,0.021824602882925686,366589,127361,
49,0.0,0,268,-219,317,25288,16151,519238,9.229331421376118E-4,239228,823,0.06976093468445618,46184,387,0,0,387,63158,0.02585533850322584,-30033,0,387,0,0.00622026488363122,0,16591,0,945,181,0,17717,15646,0.021824602882925686,366589,127361,
49,0.0,0,268,-219,317,25288,16151,519238,9.229331421376118E-4,239228,823,0.06976093468445618,46184,103,1,0,104,63158,0.02585533850322584,-30033,0,102,0,0.0808817675883871,0,16591,0,945,181,0,17717,15646,0.021824602882925686,366589,127361,
49,0.002577319587628866,0,268,-219,317,25288,16151,519238,9.229331421376118E-4,239228,823,0.06976093468445618,46184,562,215,77,854,63158,0.02585533850322584,-30033,0,347,1,0.12591434911279384,1,16591,0,945,181,1,17717,15646,0.021824602882925686,366589,127361,
49,0.002577319587628866,0,268,-219,317,25288,16151,519238,9.229331421376118E-4,239228,823,0.06976093468445618,46184,562,215,77,854,63158,0.02585533850322584,-30033,0,347,1,0.12591434911279384,1,16591,0,945,181,1,17717,15646,0.021824602882925686,366589,127361,
49,0.0,0,268,-219,317,25288,16151,519238,9.229331421376118E-4,239228,823,0.06976093468445618,46184,136,0,0,136,63158,0.02585533850322584,-30033,0,136,0,0.0020458203589211305,0,16591,0,945,181,0,17717,15646,0.021824602882925686,366589,127361,
49,0.0,0,268,-219,317,25288,16151,519238,9.229331421376118E-4,239228,823,0.06976093468445618,46184,136,0,0,136,63158,0.02585533850322584,-30033,0,136,0,0.0020458203589211305,0,16591,0,945,181,0,17717,15646,0.021824602882925686,366589,127361,
49,0.0,0,268,-219,317,25288,16151,519238,9.229331421376118E-4,239228,823,0.06976093468445618,46184,105,0,0,105,63158,0.02585533850322584,-30033,0,105,0,0.0015757011870282276,0,16591,0,945,181,0,17717,15646,0.021824602882925686,366589,127361,
49,0.0,0,268,-219,317,25288,16151,519238,9.229331421376118E-4,239228,823,0.06976093468445618,46184,105,0,0,105,63158,0.02585533850322584,-30033,0,105,0,0.0015757011870282276,0,16591,0,945,181,0,17717,15646,0.021824602882925686,366589,127361,
49,0.0,0,268,-219,317,25288,16151,519238,9.229331421376118E-4,239228,823,0.06976093468445618,46184,105,0,0,105,63158,0.02585533850322584,-30033,0,105,0,0.0015546342907906425,0,16591,0,945,181,0,17717,15646,0.021824602882925686,366589,127361,
49,0.0,0,268,-219,317,25288,16151,519238,9.229331421376118E-4,239228,823,0.06976093468445618,46184,105,0,0,105,63158,0.02585533850322584,-30033,0,105,0,0.0015546342907906425,0,16591,0,945,181,0,17717,15646,0.021824602882925686,366589,127361,
49,0.0,0,268,-219,317,25288,16151,519238,9.229331421376118E-4,239228,823,0.06976093468445618,46184,142,0,0,142,63158,0.02585533850322584,-30033,0,142,0,0.002094271724382042,0,16591,0,945,181,0,17717,15646,0.021824602882925686,366589,127361,
49,0.0,0,268,-219,317,25288,16151,519238,9.229331421376118E-4,239228,823,0.06976093468445618,46184,142,0,0,142,63158,0.02585533850322584,-30033,0,142,0,0.002094271724382042,0,16591,0,945,181,0,17717,15646,0.021824602882925686,366589,127361,
49,0.0,0,268,-219,317,25288,16151,519238,9.229331421376118E-4,239228,823,0.06976093468445618,46184,319,0,0,319,63158,0.02585533850322584,-30033,0,319,0,0.005338822781208683,0,16591,0,945,181,0,17717,15646,0.021824602882925686,366589,127361,
49,0.0,0,268,-219,317,25288,16151,519238,9.229331421376118E-4,239228,823,0.06976093468445618,46184,67,0,0,67,63158,0.02585533850322584,-30033,0,67,0,0.38285714285714284,0,16591,0,945,181,0,17717,15646,0.021824602882925686,366589,127361,
49,0.0,0,268,-219,317,25288,16151,519238,9.229331421376118E-4,239228,823,0.06976093468445618,46184,13,1,0,14,63158,0.02585533850322584,-30033,0,12,0,0.02734375,0,16591,0,945,181,0,17717,15646,0.021824602882925686,366589,127361,
49,0.0,0,268,-219,317,25288,16151,519238,9.229331421376118E-4,239228,823,0.06976093468445618,46184,13,1,0,14,63158,0.02585533850322584,-30033,0,12,0,0.02734375,0,16591,0,945,181,0,17717,15646,0.021824602882925686,366589,127361,
49,0.0,0,268,-219,317,25288,16151,519238,9.229331421376118E-4,239228,823,0.06976093468445618,46184,13,1,0,14,63158,0.02585533850322584,-30033,0,12,0,0.02734375,0,16591,0,945,181,0,17717,15646,0.021824602882925686,366589,127361,
49,0.0,0,268,-219,317,25288,16151,519238,9.229331421376118E-4,239228,823,0.06976093468445618,46184,165,0,0,165,63158,0.02585533850322584,-30033,0,165,0,0.002341388656326716,0,16591,0,945,181,0,17717,15646,0.021824602882925686,366589,127361,
49,0.0,0,268,-219,317,25288,16151,519238,9.229331421376118E-4,239228,823,0.06976093468445618,46184,165,0,0,165,63158,0.02585533850322584,-30033,0,165,0,0.002341388656326716,0,16591,0,945,181,0,17717,15646,0.021824602882925686,366589,127361,
49,0.0,0,268,-219,317,25288,16151,519238,9.229331421376118E-4,239228,823,0.06976093468445618,46184,165,0,0,165,63158,0.02585533850322584,-30033,0,165,0,0.002341388656326716,0,16591,0,945,181,0,17717,15646,0.021824602882925686,366589,127361,
49,0.0,0,268,-219,317,25288,16151,519238,9.229331421376118E-4,239228,823,0.06976093468445618,46184,165,0,0,165,63158,0.02585533850322584,-30033,0,165,0,0.002341388656326716,0,16591,0,945,181,0,17717,15646,0.021824602882925686,366589,127361,
0,0.0,0,0,0,0,25288,16151,519238,0.0,239228,823,0.06976093468445618,46184,391,8,6,405,63158,0.02585533850322584,-30033,0,383,0,0.007903272850145302,0,1258,0,21,7,0,1286,1237,0.06207790041777282,366589,127361,
0,0.0,0,0,0,0,25288,16151,519238,0.0,239228,823,0.06976093468445618,46184,516,0,0,516,63158,0.02585533850322584,-30033,0,516,0,0.00951337380342564,0,1258,0,21,7,0,1286,1237,0.06207790041777282,366589,127361,
0,0.0,0,0,0,0,25288,16151,519238,0.0,239228,823,0.06976093468445618,46184,516,0,0,516,63158,0.02585533850322584,-30033,0,516,0,0.00951337380342564,0,1258,0,21,7,0,1286,1237,0.06207790041777282,366589,127361,
0,0.0,0,0,0,0,25288,16151,519238,0.0,239228,823,0.06976093468445618,46184,29,6,0,35,63158,0.02585533850322584,-30033,0,23,0,0.025091106605862765,0,1258,0,21,7,0,1286,1237,0.06207790041777282,366589,127361,
27,0.008210180623973728,2,9,18,38,25288,16151,519238,0.002612418201794697,239228,823,0.06976093468445618,46184,178,3,0,181,63158,0.02585533850322584,-30033,2,175,8,0.007712923385098209,10,772,0,140,23,6,935,632,0.02374096889252934,366589,127361,
1,0.0,0,1,0,2,25288,16151,519238,5.02008032128514E-4,239228,823,0.06976093468445618,46184,0,4,0,4,63158,0.02585533850322584,-30033,0,-4,0,0.0125,0,685,0,433,35,0,1153,252,0.07575771270314491,366589,127361,
1,0.0,0,1,0,2,25288,16151,519238,5.02008032128514E-4,239228,823,0.06976093468445618,46184,0,4,0,4,63158,0.02585533850322584,-30033,0,-4,0,0.0125,0,685,0,433,35,0,1153,252,0.07575771270314491,366589,127361,
1,0.0,0,1,0,2,25288,16151,519238,5.02008032128514E-4,239228,823,0.06976093468445618,46184,34,67,0,101,63158,0.02585533850322584,-30033,0,-33,0,0.05567037312067121,0,685,0,433,35,0,1153,252,0.07575771270314491,366589,127361,
1,0.0,0,1,0,2,25288,16151,519238,5.02008032128514E-4,239228,823,0.06976093468445618,46184,261,53,11,325,63158,0.02585533850322584,-30033,0,208,0,0.09352729266861483,0,685,0,433,35,0,1153,252,0.07575771270314491,366589,127361,
1,0.004016064257028112,0,1,0,2,25288,16151,519238,5.02008032128514E-4,239228,823,0.06976093468445618,46184,160,40,2,202,63158,0.02585533850322584,-30033,1,120,1,0.10426424255413068,2,685,0,433,35,0,1153,252,0.07575771270314491,366589,127361,
1,0.0,0,1,0,2,25288,16151,519238,5.02008032128514E-4,239228,823,0.06976093468445618,46184,78,54,5,137,63158,0.02585533850322584,-30033,0,24,0,0.06060396792094802,0,685,0,433,35,0,1153,252,0.07575771270314491,366589,127361,
1,0.0,0,1,0,2,25288,16151,519238,5.02008032128514E-4,239228,823,0.06976093468445618,46184,78,54,5,137,63158,0.02585533850322584,-30033,0,24,0,0.06060396792094802,0,685,0,433,35,0,1153,252,0.07575771270314491,366589,127361,
1,0.0,0,1,0,2,25288,16151,519238,5.02008032128514E-4,239228,823,0.06976093468445618,46184,78,54,5,137,63158,0.02585533850322584,-30033,0,24,0,0.06060396792094802,0,685,0,433,35,0,1153,252,0.07575771270314491,366589,127361,
0,0.0,0,0,0,0,25288,16151,519238,0.0,239228,823,0.06976093468445618,46184,117,3,0,120,63158,0.02585533850322584,-30033,0,114,0,0.013335327137000067,0,301,0,5,1,0,307,296,0.237229115950195,366589,127361,
1222,0.0,10,17,1205,1249,25288,16151,519238,0.18930411196806318,239228,823,0.06976093468445618,46184,4,0,5,9,63158,0.02585533850322584,-30033,0,4,0,0.1836734693877551,0,1582,0,66,22,0,1670,1516,0.2183357252312364,366589,127361,
1222,0.0,10,17,1205,1249,25288,16151,519238,0.18930411196806318,239228,823,0.06976093468445618,46184,4,0,5,9,63158,0.02585533850322584,-30033,0,4,0,0.1836734693877551,0,1582,0,66,22,0,1670,1516,0.2183357252312364,366589,127361,
1222,0.014084507042253521,10,17,1205,1249,25288,16151,519238,0.18930411196806318,239228,823,0.06976093468445618,46184,152,7,0,159,63158,0.02585533850322584,-30033,1,145,1,0.2803744309576176,2,1582,0,66,22,0,1670,1516,0.2183357252312364,366589,127361,
1222,0.014084507042253521,10,17,1205,1249,25288,16151,519238,0.18930411196806318,239228,823,0.06976093468445618,46184,152,7,0,159,63158,0.02585533850322584,-30033,1,145,1,0.2803744309576176,2,1582,0,66,22,0,1670,1516,0.2183357252312364,366589,127361,
1222,0.2222222222222222,10,17,1205,1249,25288,16151,519238,0.18930411196806318,239228,823,0.06976093468445618,46184,21,8,2,31,63158,0.02585533850322584,-30033,3,13,7,0.07116892656273978,10,1582,0,66,22,4,1670,1516,0.2183357252312364,366589,127361,
1222,0.45614035087719296,10,17,1205,1249,25288,16151,519238,0.18930411196806318,239228,823,0.06976093468445618,46184,120,46,15,181,63158,0.02585533850322584,-30033,13,74,55,0.15904165121664693,78,1582,10,66,22,42,1670,1516,0.2183357252312364,366589,127361,
1222,0.8219858156028369,10,17,1205,1249,25288,16151,519238,0.18930411196806318,239228,823,0.06976093468445618,46184,1159,0,0,1159,63158,0.02585533850322584,-30033,0,1159,1159,0.8219858156028369,1159,1582,0,66,22,1159,1670,1516,0.2183357252312364,366589,127361,
0,0.0,0,0,0,0,25288,16151,519238,0.0,239228,823,0.06976093468445618,46184,10,2,0,12,63158,0.02585533850322584,-30033,0,8,0,0.07660953711729522,0,63,0,2,0,0,65,61,0.02948617804463304,366589,127361,
0,0.0,0,0,0,0,25288,16151,519238,0.0,239228,823,0.06976093468445618,46184,49,0,0,49,63158,0.02585533850322584,-30033,0,49,0,0.01052405498281787,0,63,0,2,0,0,65,61,0.02948617804463304,366589,127361,
3,0.010570824524312896,0,2,1,5,25288,16151,519238,0.002642706131078224,239228,823,0.06976093468445618,46184,3,2,0,5,63158,0.02585533850322584,-30033,2,1,3,0.010570824524312896,5,368,0,2,0,1,370,366,0.03914636374914997,366589,127361,
3,0.010570824524312896,0,2,1,5,25288,16151,519238,0.002642706131078224,239228,823,0.06976093468445618,46184,3,2,0,5,63158,0.02585533850322584,-30033,2,1,3,0.010570824524312896,5,368,0,2,0,1,370,366,0.03914636374914997,366589,127361,
3,0.010570824524312896,0,2,1,5,25288,16151,519238,0.002642706131078224,239228,823,0.06976093468445618,46184,3,2,0,5,63158,0.02585533850322584,-30033,2,1,3,0.010570824524312896,5,368,0,2,0,1,370,366,0.03914636374914997,366589,127361,
4,0.0,0,4,0,8,25288,16151,519238,0.002898550724637681,239228,823,0.06976093468445618,46184,509,136,23,668,63158,0.02585533850322584,-30033,0,373,0,0.05998724451605567,0,1270,0,213,29,0,1512,1057,0.03498967655105192,366589,127361,
4,0.0,0,4,0,8,25288,16151,519238,0.002898550724637681,239228,823,0.06976093468445618,46184,509,136,23,668,63158,0.02585533850322584,-30033,0,373,0,0.05998724451605567,0,1270,0,213,29,0,1512,1057,0.03498967655105192,366589,127361,
4,0.0,0,4,0,8,25288,16151,519238,0.002898550724637681,239228,823,0.06976093468445618,46184,408,22,0,430,63158,0.02585533850322584,-30033,0,386,0,0.10218216086649688,0,1270,0,213,29,0,1512,1057,0.03498967655105192,366589,127361,
4,0.0,0,4,0,8,25288,16151,519238,0.002898550724637681,239228,823,0.06976093468445618,46184,408,22,0,430,63158,0.02585533850322584,-30033,0,386,0,0.10218216086649688,0,1270,0,213,29,0,1512,1057,0.03498967655105192,366589,127361,
224,0.0,0,541,-317,765,25288,16151,519238,0.014488846786882493,239228,823,0.06976093468445618,46184,0,0,0,0,63158,0.02585533850322584,-30033,0,0,0,0.0,0,2435,0,682,901,0,4018,1753,0.12751645144468654,366589,127361,
224,0.0,0,541,-317,765,25288,16151,519238,0.014488846786882493,239228,823,0.06976093468445618,46184,0,0,0,0,63158,0.02585533850322584,-30033,0,0,0,0.0,0,2435,0,682,901,0,4018,1753,0.12751645144468654,366589,127361,
224,0.0,0,541,-317,765,25288,16151,519238,0.014488846786882493,239228,823,0.06976093468445618,46184,143,0,0,143,63158,0.02585533850322584,-30033,0,143,0,0.13095238095238096,0,2435,0,682,901,0,4018,1753,0.12751645144468654,366589,127361,
224,0.0,0,541,-317,765,25288,16151,519238,0.014488846786882493,239228,823,0.06976093468445618,46184,143,0,0,143,63158,0.02585533850322584,-30033,0,143,0,0.13095238095238096,0,2435,0,682,901,0,4018,1753,0.12751645144468654,366589,127361,
224,0.06292517006802721,0,541,-317,765,25288,16151,519238,0.014488846786882493,239228,823,0.06976093468445618,46184,621,56,595,1272,63158,0.02585533850322584,-30033,25,565,12,0.09607964051443754,37,2435,0,682,901,-13,4018,1753,0.12751645144468654,366589,127361,
224,0.0,0,541,-317,765,25288,16151,519238,0.014488846786882493,239228,823,0.06976093468445618,46184,55,17,81,153,63158,0.02585533850322584,-30033,0,38,0,0.08234169854388913,0,2435,0,682,901,0,4018,1753,0.12751645144468654,366589,127361,
224,0.0,0,541,-317,765,25288,16151,519238,0.014488846786882493,239228,823,0.06976093468445618,46184,55,17,81,153,63158,0.02585533850322584,-30033,0,38,0,0.08234169854388913,0,2435,0,682,901,0,4018,1753,0.12751645144468654,366589,127361,
224,0.0,0,541,-317,765,25288,16151,519238,0.014488846786882493,239228,823,0.06976093468445618,46184,55,17,81,153,63158,0.02585533850322584,-30033,0,38,0,0.08234169854388913,0,2435,0,682,901,0,4018,1753,0.12751645144468654,366589,127361,
224,0.0,0,541,-317,765,25288,16151,519238,0.014488846786882493,239228,823,0.06976093468445618,46184,55,17,81,153,63158,0.02585533850322584,-30033,0,38,0,0.08234169854388913,0,2435,0,682,901,0,4018,1753,0.12751645144468654,366589,127361,
224,0.0,0,541,-317,765,25288,16151,519238,0.014488846786882493,239228,823,0.06976093468445618,46184,55,17,81,153,63158,0.02585533850322584,-30033,0,38,0,0.08234169854388913,0,2435,0,682,901,0,4018,1753,0.12751645144468654,366589,127361,
224,0.0,0,541,-317,765,25288,16151,519238,0.014488846786882493,239228,823,0.06976093468445618,46184,55,17,81,153,63158,0.02585533850322584,-30033,0,38,0,0.08234169854388913,0,2435,0,682,901,0,4018,1753,0.12751645144468654,366589,127361,
224,0.0,0,541,-317,765,25288,16151,519238,0.014488846786882493,239228,823,0.06976093468445618,46184,55,17,81,153,63158,0.02585533850322584,-30033,0,38,0,0.08234169854388913,0,2435,0,682,901,0,4018,1753,0.12751645144468654,366589,127361,
224,0.0,0,541,-317,765,25288,16151,519238,0.014488846786882493,239228,823,0.06976093468445618,46184,55,17,81,153,63158,0.02585533850322584,-30033,0,38,0,0.08234169854388913,0,2435,0,682,901,0,4018,1753,0.12751645144468654,366589,127361,
224,0.0189873417721519,0,541,-317,765,25288,16151,519238,0.014488846786882493,239228,823,0.06976093468445618,46184,162,33,188,383,63158,0.02585533850322584,-30033,9,129,3,0.2386236165140284,12,2435,0,682,901,-6,4018,1753,0.12751645144468654,366589,127361,
224,0.0189873417721519,0,541,-317,765,25288,16151,519238,0.014488846786882493,239228,823,0.06976093468445618,46184,162,33,188,383,63158,0.02585533850322584,-30033,9,129,3,0.2386236165140284,12,2435,0,682,901,-6,4018,1753,0.12751645144468654,366589,127361,
224,0.0189873417721519,0,541,-317,765,25288,16151,519238,0.014488846786882493,239228,823,0.06976093468445618,46184,162,33,188,383,63158,0.02585533850322584,-30033,9,129,3,0.2386236165140284,12,2435,0,682,901,-6,4018,1753,0.12751645144468654,366589,127361,
224,0.0189873417721519,0,541,-317,765,25288,16151,519238,0.014488846786882493,239228,823,0.06976093468445618,46184,162,33,188,383,63158,0.02585533850322584,-30033,9,129,3,0.2386236165140284,12,2435,0,682,901,-6,4018,1753,0.12751645144468654,366589,127361,
224,0.0189873417721519,0,541,-317,765,25288,16151,519238,0.014488846786882493,239228,823,0.06976093468445618,46184,162,33,188,383,63158,0.02585533850322584,-30033,9,129,3,0.2386236165140284,12,2435,0,682,901,-6,4018,1753,0.12751645144468654,366589,127361,
224,0.0189873417721519,0,541,-317,765,25288,16151,519238,0.014488846786882493,239228,823,0.06976093468445618,46184,162,33,188,383,63158,0.02585533850322584,-30033,9,129,3,0.2386236165140284,12,2435,0,682,901,-6,4018,1753,0.12751645144468654,366589,127361,
224,0.0,0,541,-317,765,25288,16151,519238,0.014488846786882493,239228,823,0.06976093468445618,46184,236,20,19,275,63158,0.02585533850322584,-30033,0,216,0,0.408462507790749,0,2435,0,682,901,0,4018,1753,0.12751645144468654,366589,127361,
224,0.0,0,541,-317,765,25288,16151,519238,0.014488846786882493,239228,823,0.06976093468445618,46184,236,20,19,275,63158,0.02585533850322584,-30033,0,216,0,0.408462507790749,0,2435,0,682,901,0,4018,1753,0.12751645144468654,366589,127361,
224,0.0,0,541,-317,765,25288,16151,519238,0.014488846786882493,239228,823,0.06976093468445618,46184,236,20,19,275,63158,0.02585533850322584,-30033,0,216,0,0.408462507790749,0,2435,0,682,901,0,4018,1753,0.12751645144468654,366589,127361,
224,0.0,0,541,-317,765,25288,16151,519238,0.014488846786882493,239228,823,0.06976093468445618,46184,236,20,19,275,63158,0.02585533850322584,-30033,0,216,0,0.408462507790749,0,2435,0,682,901,0,4018,1753,0.12751645144468654,366589,127361,
224,0.0,0,541,-317,765,25288,16151,519238,0.014488846786882493,239228,823,0.06976093468445618,46184,236,20,19,275,63158,0.02585533850322584,-30033,0,216,0,0.408462507790749,0,2435,0,682,901,0,4018,1753,0.12751645144468654,366589,127361,
224,0.0,0,541,-317,765,25288,16151,519238,0.014488846786882493,239228,823,0.06976093468445618,46184,236,20,19,275,63158,0.02585533850322584,-30033,0,216,0,0.408462507790749,0,2435,0,682,901,0,4018,1753,0.12751645144468654,366589,127361,
224,0.0,0,541,-317,765,25288,16151,519238,0.014488846786882493,239228,823,0.06976093468445618,46184,236,20,19,275,63158,0.02585533850322584,-30033,0,216,0,0.408462507790749,0,2435,0,682,901,0,4018,1753,0.12751645144468654,366589,127361,
224,0.0,0,541,-317,765,25288,16151,519238,0.014488846786882493,239228,823,0.06976093468445618,46184,236,20,19,275,63158,0.02585533850322584,-30033,0,216,0,0.408462507790749,0,2435,0,682,901,0,4018,1753,0.12751645144468654,366589,127361,
224,0.0,0,541,-317,765,25288,16151,519238,0.014488846786882493,239228,823,0.06976093468445618,46184,236,20,19,275,63158,0.02585533850322584,-30033,0,216,0,0.408462507790749,0,2435,0,682,901,0,4018,1753,0.12751645144468654,366589,127361,
224,0.0,0,541,-317,765,25288,16151,519238,0.014488846786882493,239228,823,0.06976093468445618,46184,236,20,19,275,63158,0.02585533850322584,-30033,0,216,0,0.408462507790749,0,2435,0,682,901,0,4018,1753,0.12751645144468654,366589,127361,
224,0.0,0,541,-317,765,25288,16151,519238,0.014488846786882493,239228,823,0.06976093468445618,46184,236,20,19,275,63158,0.02585533850322584,-30033,0,216,0,0.408462507790749,0,2435,0,682,901,0,4018,1753,0.12751645144468654,366589,127361,
224,0.0,0,541,-317,765,25288,16151,519238,0.014488846786882493,239228,823,0.06976093468445618,46184,236,20,19,275,63158,0.02585533850322584,-30033,0,216,0,0.408462507790749,0,2435,0,682,901,0,4018,1753,0.12751645144468654,366589,127361,
224,0.0,0,541,-317,765,25288,16151,519238,0.014488846786882493,239228,823,0.06976093468445618,46184,236,20,19,275,63158,0.02585533850322584,-30033,0,216,0,0.408462507790749,0,2435,0,682,901,0,4018,1753,0.12751645144468654,366589,127361,
224,0.0,0,541,-317,765,25288,16151,519238,0.014488846786882493,239228,823,0.06976093468445618,46184,236,20,19,275,63158,0.02585533850322584,-30033,0,216,0,0.408462507790749,0,2435,0,682,901,0,4018,1753,0.12751645144468654,366589,127361,
224,0.0,0,541,-317,765,25288,16151,519238,0.014488846786882493,239228,823,0.06976093468445618,46184,236,20,19,275,63158,0.02585533850322584,-30033,0,216,0,0.408462507790749,0,2435,0,682,901,0,4018,1753,0.12751645144468654,366589,127361,
224,0.0,0,541,-317,765,25288,16151,519238,0.014488846786882493,239228,823,0.06976093468445618,46184,236,20,19,275,63158,0.02585533850322584,-30033,0,216,0,0.408462507790749,0,2435,0,682,901,0,4018,1753,0.12751645144468654,366589,127361,
224,0.0,0,541,-317,765,25288,16151,519238,0.014488846786882493,239228,823,0.06976093468445618,46184,236,20,19,275,63158,0.02585533850322584,-30033,0,216,0,0.408462507790749,0,2435,0,682,901,0,4018,1753,0.12751645144468654,366589,127361,
224,0.0,0,541,-317,765,25288,16151,519238,0.014488846786882493,239228,823,0.06976093468445618,46184,236,20,19,275,63158,0.02585533850322584,-30033,0,216,0,0.408462507790749,0,2435,0,682,901,0,4018,1753,0.12751645144468654,366589,127361,
224,0.0,0,541,-317,765,25288,16151,519238,0.014488846786882493,239228,823,0.06976093468445618,46184,236,20,19,275,63158,0.02585533850322584,-30033,0,216,0,0.408462507790749,0,2435,0,682,901,0,4018,1753,0.12751645144468654,366589,127361,
224,0.0,0,541,-317,765,25288,16151,519238,0.014488846786882493,239228,823,0.06976093468445618,46184,236,20,19,275,63158,0.02585533850322584,-30033,0,216,0,0.408462507790749,0,2435,0,682,901,0,4018,1753,0.12751645144468654,366589,127361,
224,0.0,0,541,-317,765,25288,16151,519238,0.014488846786882493,239228,823,0.06976093468445618,46184,236,20,19,275,63158,0.02585533850322584,-30033,0,216,0,0.408462507790749,0,2435,0,682,901,0,4018,1753,0.12751645144468654,366589,127361,
224,0.0,0,541,-317,765,25288,16151,519238,0.014488846786882493,239228,823,0.06976093468445618,46184,236,20,19,275,63158,0.02585533850322584,-30033,0,216,0,0.408462507790749,0,2435,0,682,901,0,4018,1753,0.12751645144468654,366589,127361,
224,0.0,0,541,-317,765,25288,16151,519238,0.014488846786882493,239228,823,0.06976093468445618,46184,236,20,19,275,63158,0.02585533850322584,-30033,0,216,0,0.408462507790749,0,2435,0,682,901,0,4018,1753,0.12751645144468654,366589,127361,
224,0.0,0,541,-317,765,25288,16151,519238,0.014488846786882493,239228,823,0.06976093468445618,46184,236,20,19,275,63158,0.02585533850322584,-30033,0,216,0,0.408462507790749,0,2435,0,682,901,0,4018,1753,0.12751645144468654,366589,127361,
224,0.0,0,541,-317,765,25288,16151,519238,0.014488846786882493,239228,823,0.06976093468445618,46184,236,20,19,275,63158,0.02585533850322584,-30033,0,216,0,0.408462507790749,0,2435,0,682,901,0,4018,1753,0.12751645144468654,366589,127361,
224,0.0,0,541,-317,765,25288,16151,519238,0.014488846786882493,239228,823,0.06976093468445618,46184,236,20,19,275,63158,0.02585533850322584,-30033,0,216,0,0.408462507790749,0,2435,0,682,901,0,4018,1753,0.12751645144468654,366589,127361,
224,0.0,0,541,-317,765,25288,16151,519238,0.014488846786882493,239228,823,0.06976093468445618,46184,236,20,19,275,63158,0.02585533850322584,-30033,0,216,0,0.408462507790749,0,2435,0,682,901,0,4018,1753,0.12751645144468654,366589,127361,
224,0.0,0,541,-317,765,25288,16151,519238,0.014488846786882493,239228,823,0.06976093468445618,46184,236,20,19,275,63158,0.02585533850322584,-30033,0,216,0,0.408462507790749,0,2435,0,682,901,0,4018,1753,0.12751645144468654,366589,127361,
224,0.04355885078776645,0,541,-317,765,25288,16151,519238,0.014488846786882493,239228,823,0.06976093468445618,46184,94,0,0,94,63158,0.02585533850322584,-30033,0,94,94,0.04355885078776645,94,2435,0,682,901,94,4018,1753,0.12751645144468654,366589,127361,
224,0.04355885078776645,0,541,-317,765,25288,16151,519238,0.014488846786882493,239228,823,0.06976093468445618,46184,94,0,0,94,63158,0.02585533850322584,-30033,0,94,94,0.04355885078776645,94,2435,0,682,901,94,4018,1753,0.12751645144468654,366589,127361,
224,0.04355885078776645,0,541,-317,765,25288,16151,519238,0.014488846786882493,239228,823,0.06976093468445618,46184,94,0,0,94,63158,0.02585533850322584,-30033,0,94,94,0.04355885078776645,94,2435,0,682,901,94,4018,1753,0.12751645144468654,366589,127361,
224,0.0045443861161169,0,541,-317,765,25288,16151,519238,0.014488846786882493,239228,823,0.06976093468445618,46184,248,304,14,566,63158,0.02585533850322584,-30033,290,-56,0,0.1751879485373766,290,2435,0,682,901,-290,4018,1753,0.12751645144468654,366589,127361,
224,0.0045443861161169,0,541,-317,765,25288,16151,519238,0.014488846786882493,239228,823,0.06976093468445618,46184,248,304,14,566,63158,0.02585533850322584,-30033,290,-56,0,0.1751879485373766,290,2435,0,682,901,-290,4018,1753,0.12751645144468654,366589,127361,
224,0.0045443861161169,0,541,-317,765,25288,16151,519238,0.014488846786882493,239228,823,0.06976093468445618,46184,248,304,14,566,63158,0.02585533850322584,-30033,290,-56,0,0.1751879485373766,290,2435,0,682,901,-290,4018,1753,0.12751645144468654,366589,127361,
224,0.0045443861161169,0,541,-317,765,25288,16151,519238,0.014488846786882493,239228,823,0.06976093468445618,46184,248,304,14,566,63158,0.02585533850322584,-30033,290,-56,0,0.1751879485373766,290,2435,0,682,901,-290,4018,1753,0.12751645144468654,366589,127361,
224,0.0045443861161169,0,541,-317,765,25288,16151,519238,0.014488846786882493,239228,823,0.06976093468445618,46184,248,304,14,566,63158,0.02585533850322584,-30033,290,-56,0,0.1751879485373766,290,2435,0,682,901,-290,4018,1753,0.12751645144468654,366589,127361,
224,0.0,0,541,-317,765,25288,16151,519238,0.014488846786882493,239228,823,0.06976093468445618,46184,64,0,0,64,63158,0.02585533850322584,-30033,0,64,0,0.11307420494699646,0,2435,0,682,901,0,4018,1753,0.12751645144468654,366589,127361,
224,0.0,0,541,-317,765,25288,16151,519238,0.014488846786882493,239228,823,0.06976093468445618,46184,64,0,0,64,63158,0.02585533850322584,-30033,0,64,0,0.11307420494699646,0,2435,0,682,901,0,4018,1753,0.12751645144468654,366589,127361,
